name	description	page
ensembl_gene_id	Gene stable ID	feature_page
ensembl_gene_id_version	Gene stable ID version	feature_page
ensembl_transcript_id	Transcript stable ID	feature_page
ensembl_transcript_id_version	Transcript stable ID version	feature_page
ensembl_peptide_id	Protein stable ID	feature_page
ensembl_peptide_id_version	Protein stable ID version	feature_page
ensembl_exon_id	Exon stable ID	feature_page
description	Gene description	feature_page
chromosome_name	Chromosome/scaffold name	feature_page
start_position	Gene start (bp)	feature_page
end_position	Gene end (bp)	feature_page
strand	Strand	feature_page
band	Karyotype band	feature_page
transcript_start	Transcript start (bp)	feature_page
transcript_end	Transcript end (bp)	feature_page
transcription_start_site	Transcription start site (TSS)	feature_page
transcript_length	Transcript length (including UTRs and CDS)	feature_page
transcript_gencode_basic	GENCODE basic annotation	feature_page
external_gene_name	Gene name	feature_page
external_gene_source	Source of gene name	feature_page
external_transcript_name	Transcript name	feature_page
external_transcript_source_name	Source of transcript name	feature_page
transcript_count	Transcript count	feature_page
percentage_gene_gc_content	Gene % GC content	feature_page
gene_biotype	Gene type	feature_page
transcript_biotype	Transcript type	feature_page
source	Source (gene)	feature_page
transcript_source	Source (transcript)	feature_page
version	Version (gene)	feature_page
transcript_version	Version (transcript)	feature_page
phenotype_description	Phenotype description	feature_page
source_name	Source name	feature_page
study_external_id	Study external reference	feature_page
strain_name	Strain name	feature_page
strain_gender	Strain gender	feature_page
p_value	P value	feature_page
go_id	GO term accession	feature_page
name_1006	GO term name	feature_page
definition_1006	GO term definition	feature_page
go_linkage_type	GO term evidence code	feature_page
namespace_1003	GO domain	feature_page
goslim_goa_accession	GOSlim GOA Accession(s)	feature_page
goslim_goa_description	GOSlim GOA Description	feature_page
arrayexpress	ArrayExpress ID	feature_page
ccds	CCDS ID	feature_page
chembl	ChEMBL ID	feature_page
clone_based_ensembl_gene	Clone-based (Ensembl) gene ID	feature_page
clone_based_ensembl_transcript	Clone-based (Ensembl) transcript ID	feature_page
clone_based_vega_gene	Clone-based (Vega) gene ID	feature_page
clone_based_vega_transcript	Clone-based (Vega) transcript ID	feature_page
dbass3_name	DataBase of Aberrant 3' Splice Sites name	feature_page
dbass3_id	DataBase of Aberrant 3' Splice Sites ID	feature_page
ens_hs_translation	Ensembl Human Translation ID	feature_page
entrezgene	EntrezGene ID	feature_page
embl	European Nucleotide Archive ID	feature_page
ottg	Havana gene ID	feature_page
ottt	Havana transcript ID	feature_page
shares_cds_with_ottt	Havana transcript having same CDS ID	feature_page
hgnc_symbol	HGNC symbol	feature_page
hgnc_id	HGNC ID	feature_page
hgnc_trans_name	HGNC transcript name ID	feature_page
hpa	Human Protein Atlas ID	feature_page
protein_id	INSDC protein ID	feature_page
kegg_enzyme	KEGG ID	feature_page
lrg	Locus Reference Genomic ID	feature_page
ens_lrg_gene	LRG display in Ensembl gene ID	feature_page
ens_lrg_transcript	LRG display in Ensembl transcript ID	feature_page
merops	MEROPS - the Peptidase Database ID	feature_page
metacyc	MetaCyc ID	feature_page
mim_morbid_description	MIM disease description	feature_page
mim_morbid_accession	MIM disease accession	feature_page
mim_gene_description	MIM gene description	feature_page
mim_gene_accession	MIM gene accession	feature_page
mirbase_id	miRBase ID	feature_page
mirbase_accession	miRBase accession	feature_page
mirbase_trans_name	miRBase transcript name ID	feature_page
pdb	PDB ID	feature_page
reactome	Reactome ID	feature_page
refseq_mrna	RefSeq mRNA ID	feature_page
refseq_mrna_predicted	RefSeq mRNA predicted ID	feature_page
refseq_ncrna	RefSeq ncRNA ID	feature_page
refseq_ncrna_predicted	RefSeq ncRNA predicted ID	feature_page
refseq_peptide	RefSeq peptide ID	feature_page
refseq_peptide_predicted	RefSeq peptide predicted ID	feature_page
rfam	RFAM ID	feature_page
rfam_trans_name	RFAM transcript name ID	feature_page
shares_cds_and_utr_with_ottt	Transcript having exact match between ENSEMBL and HAVANA ID	feature_page
ucsc	UCSC Stable ID	feature_page
unigene	UniGene ID	feature_page
uniparc	UniParc ID	feature_page
unipathway	UniPathway ID	feature_page
uniprot_gn_trans_name	UniProt transcript name ID	feature_page
uniprot_gn	UniProtKB Gene Name ID	feature_page
uniprotswissprot	UniProtKB/Swiss-Prot ID	feature_page
uniprotsptrembl	UniProtKB/TrEMBL ID	feature_page
vega_transcript	Vega transcript ID	feature_page
vega_translation	Vega translation ID	feature_page
wikigene_description	WikiGene description	feature_page
wikigene_name	WikiGene name	feature_page
wikigene_id	WikiGene ID	feature_page
affy_hc_g110	AFFY HC G110 probe	feature_page
affy_hg_focus	AFFY HG Focus probe	feature_page
affy_hg_u133a	AFFY HG U133A probe	feature_page
affy_hg_u133a_2	AFFY HG U133A 2 probe	feature_page
affy_hg_u133b	AFFY HG U133B probe	feature_page
affy_hg_u133_plus_2	AFFY HG U133 Plus 2 probe	feature_page
affy_hg_u95a	AFFY HG U95A probe	feature_page
affy_hg_u95av2	AFFY HG U95Av2 probe	feature_page
affy_hg_u95b	AFFY HG U95B probe	feature_page
affy_hg_u95c	AFFY HG U95C probe	feature_page
affy_hg_u95d	AFFY HG U95D probe	feature_page
affy_hg_u95e	AFFY HG U95E probe	feature_page
affy_hta_2_0	AFFY HTA 2 0 probe	feature_page
affy_huex_1_0_st_v2	AFFY HuEx 1 0 st v2 probe	feature_page
affy_hugenefl	AFFY HuGeneFL probe	feature_page
affy_hugene_1_0_st_v1	AFFY HuGene 1 0 st v1 probe	feature_page
affy_hugene_2_0_st_v1	AFFY HuGene 2 0 st v1 probe	feature_page
affy_primeview	AFFY PrimeView probe	feature_page
affy_u133_x3p	AFFY U133 X3P probe	feature_page
agilent_cgh_44b	AGILENT CGH 44b probe	feature_page
agilent_sureprint_g3_ge_8x60k	AGILENT SurePrint G3 GE 8x60k probe	feature_page
agilent_sureprint_g3_ge_8x60k_v2	AGILENT SurePrint G3 GE 8x60k v2 probe	feature_page
agilent_wholegenome_4x44k_v1	AGILENT WholeGenome 4x44k v1 probe	feature_page
agilent_wholegenome_4x44k_v2	AGILENT WholeGenome 4x44k v2 probe	feature_page
codelink_codelink	CODELINK CODELINK probe	feature_page
illumina_humanht_12_v3	ILLUMINA HumanHT 12 V3 probe	feature_page
illumina_humanht_12_v4	ILLUMINA HumanHT 12 V4 probe	feature_page
illumina_humanref_8_v3	ILLUMINA HumanRef 8 V3 probe	feature_page
illumina_humanwg_6_v1	ILLUMINA HumanWG 6 V1 probe	feature_page
illumina_humanwg_6_v2	ILLUMINA HumanWG 6 V2 probe	feature_page
illumina_humanwg_6_v3	ILLUMINA HumanWG 6 V3 probe	feature_page
phalanx_onearray	PHALANX OneArray probe	feature_page
family	Ensembl Protein Family ID(s)	feature_page
family_description	Ensembl Family Description	feature_page
gene3d	Gene3D ID	feature_page
gene3d_start	Gene3D start	feature_page
gene3d_end	Gene3D end	feature_page
hamap	HAMAP ID	feature_page
hamap_start	HAMAP start	feature_page
hamap_end	HAMAP end	feature_page
hmmpanther	hmmpanther ID	feature_page
hmmpanther_start	hmmpanther start	feature_page
hmmpanther_end	hmmpanther end	feature_page
pfam	Pfam domain ID	feature_page
pfam_start	Pfam domain start	feature_page
pfam_end	Pfam domain end	feature_page
pirsf	PIRSF domain ID	feature_page
pirsf_start	PIRSF domain start	feature_page
pirsf_end	PIRSF domain end	feature_page
prints	Prints domain ID	feature_page
prints_start	Prints domain start	feature_page
prints_end	Prints domain end	feature_page
scanprosite	PROSITE patterns ID	feature_page
scanprosite_start	PROSITE patterns start	feature_page
scanprosite_end	PROSITE patterns end	feature_page
pfscan	PROSITE profiles ID	feature_page
pfscan_start	PROSITE profiles start	feature_page
pfscan_end	PROSITE profiles end	feature_page
smart	SMART domains ID	feature_page
smart_start	SMART domains start	feature_page
smart_end	SMART domains end	feature_page
superfamily	Superfamily domains ID	feature_page
superfamily_start	Superfamily domains start	feature_page
superfamily_end	Superfamily domains end	feature_page
tigrfam	TIGRFAM domain ID	feature_page
tigrfam_start	TIGRFAM domain start	feature_page
tigrfam_end	TIGRFAM domain end	feature_page
interpro	Interpro ID	feature_page
interpro_short_description	Interpro Short Description	feature_page
interpro_description	Interpro Description	feature_page
interpro_start	Interpro start	feature_page
interpro_end	Interpro end	feature_page
ncoils	Coiled-coils (Ncoils)	feature_page
ncoils_start	Coiled-coils (Ncoils) start	feature_page
ncoils_end	Coiled-coils (Ncoils) end	feature_page
seg	Low complexity (Seg)	feature_page
seg_start	Low complexity (Seg) start	feature_page
seg_end	Low complexity (Seg) end	feature_page
signalp	Cleavage site (Signalp)	feature_page
signalp_start	Cleavage site (Signalp) start	feature_page
signalp_end	Cleavage site (Signalp) end	feature_page
tmhmm	Transmembrane helices	feature_page
tmhmm_start	Transmembrane helices start	feature_page
tmhmm_end	Transmembrane helices end	feature_page
ensembl_gene_id	Gene stable ID	structure
ensembl_transcript_id	Transcript stable ID	structure
ensembl_peptide_id	Protein stable ID	structure
chromosome_name	Chromosome/scaffold name	structure
start_position	Gene start (bp)	structure
end_position	Gene end (bp)	structure
transcript_start	Transcript start (bp)	structure
transcript_end	Transcript end (bp)	structure
transcription_start_site	Transcription start site (TSS)	structure
transcript_length	Transcript length (including UTRs and CDS)	structure
strand	Strand	structure
external_gene_name	Gene name	structure
external_gene_source	Source of gene name	structure
5_utr_start	5' UTR start	structure
5_utr_end	5' UTR end	structure
3_utr_start	3' UTR start	structure
3_utr_end	3' UTR end	structure
cds_length	CDS Length	structure
transcript_count	Transcript count	structure
description	Gene description	structure
gene_biotype	Gene type	structure
exon_chrom_start	Exon region start (bp)	structure
exon_chrom_end	Exon region end (bp)	structure
is_constitutive	Constitutive exon	structure
rank	Exon rank in transcript	structure
phase	Start phase	structure
end_phase	End phase	structure
cdna_coding_start	cDNA coding start	structure
cdna_coding_end	cDNA coding end	structure
genomic_coding_start	Genomic coding start	structure
genomic_coding_end	Genomic coding end	structure
ensembl_exon_id	Exon stable ID	structure
cds_start	CDS start	structure
cds_end	CDS end	structure
ensembl_gene_id	Gene stable ID	homologs
ensembl_transcript_id	Transcript stable ID	homologs
ensembl_peptide_id	Protein stable ID	homologs
chromosome_name	Chromosome/scaffold name	homologs
start_position	Gene start (bp)	homologs
end_position	Gene end (bp)	homologs
strand	Strand	homologs
band	Karyotype band	homologs
external_gene_name	Gene name	homologs
external_gene_source	Source of gene name	homologs
transcript_count	Transcript count	homologs
percentage_gene_gc_content	Gene % GC content	homologs
description	Gene description	homologs
vpacos_homolog_ensembl_gene	Alpaca gene stable ID	homologs
vpacos_homolog_associated_gene_name	Alpaca gene name	homologs
vpacos_homolog_ensembl_peptide	Alpaca protein or transcript stable ID	homologs
vpacos_homolog_chromosome	Alpaca chromosome/scaffold name	homologs
vpacos_homolog_chrom_start	Alpaca chromosome/scaffold start (bp)	homologs
vpacos_homolog_chrom_end	Alpaca chromosome/scaffold end (bp)	homologs
vpacos_homolog_canonical_transcript_protein	Query protein or transcript ID	homologs
vpacos_homolog_subtype	Last common ancestor with Alpaca	homologs
vpacos_homolog_orthology_type	Alpaca homology type	homologs
vpacos_homolog_perc_id	%id. target Alpaca gene identical to query gene	homologs
vpacos_homolog_perc_id_r1	%id. query gene identical to target Alpaca gene	homologs
vpacos_homolog_goc_score	Alpaca Gene-order conservation score	homologs
vpacos_homolog_wga_coverage	Alpaca Whole-genome alignment coverage	homologs
vpacos_homolog_dn	dN with Alpaca	homologs
vpacos_homolog_ds	dS with Alpaca	homologs
vpacos_homolog_orthology_confidence	Alpaca orthology confidence [0 low, 1 high]	homologs
acarolinensis_homolog_ensembl_gene	Anole lizard gene stable ID	homologs
acarolinensis_homolog_associated_gene_name	Anole lizard gene name	homologs
acarolinensis_homolog_ensembl_peptide	Anole lizard protein or transcript stable ID	homologs
acarolinensis_homolog_chromosome	Anole lizard chromosome/scaffold name	homologs
acarolinensis_homolog_chrom_start	Anole lizard chromosome/scaffold start (bp)	homologs
acarolinensis_homolog_chrom_end	Anole lizard chromosome/scaffold end (bp)	homologs
acarolinensis_homolog_canonical_transcript_protein	Query protein or transcript ID	homologs
acarolinensis_homolog_subtype	Last common ancestor with Anole lizard	homologs
acarolinensis_homolog_orthology_type	Anole lizard homology type	homologs
acarolinensis_homolog_perc_id	%id. target Anole lizard gene identical to query gene	homologs
acarolinensis_homolog_perc_id_r1	%id. query gene identical to target Anole lizard gene	homologs
acarolinensis_homolog_goc_score	Anole lizard Gene-order conservation score	homologs
acarolinensis_homolog_wga_coverage	Anole lizard Whole-genome alignment coverage	homologs
acarolinensis_homolog_dn	dN with Anole lizard	homologs
acarolinensis_homolog_ds	dS with Anole lizard	homologs
acarolinensis_homolog_orthology_confidence	Anole lizard orthology confidence [0 low, 1 high]	homologs
dnovemcinctus_homolog_ensembl_gene	Armadillo gene stable ID	homologs
dnovemcinctus_homolog_associated_gene_name	Armadillo gene name	homologs
dnovemcinctus_homolog_ensembl_peptide	Armadillo protein or transcript stable ID	homologs
dnovemcinctus_homolog_chromosome	Armadillo chromosome/scaffold name	homologs
dnovemcinctus_homolog_chrom_start	Armadillo chromosome/scaffold start (bp)	homologs
dnovemcinctus_homolog_chrom_end	Armadillo chromosome/scaffold end (bp)	homologs
dnovemcinctus_homolog_canonical_transcript_protein	Query protein or transcript ID	homologs
dnovemcinctus_homolog_subtype	Last common ancestor with Armadillo	homologs
dnovemcinctus_homolog_orthology_type	Armadillo homology type	homologs
dnovemcinctus_homolog_perc_id	%id. target Armadillo gene identical to query gene	homologs
dnovemcinctus_homolog_perc_id_r1	%id. query gene identical to target Armadillo gene	homologs
dnovemcinctus_homolog_goc_score	Armadillo Gene-order conservation score	homologs
dnovemcinctus_homolog_wga_coverage	Armadillo Whole-genome alignment coverage	homologs
dnovemcinctus_homolog_dn	dN with Armadillo	homologs
dnovemcinctus_homolog_ds	dS with Armadillo	homologs
dnovemcinctus_homolog_orthology_confidence	Armadillo orthology confidence [0 low, 1 high]	homologs
ogarnettii_homolog_ensembl_gene	Bushbaby gene stable ID	homologs
ogarnettii_homolog_associated_gene_name	Bushbaby gene name	homologs
ogarnettii_homolog_ensembl_peptide	Bushbaby protein or transcript stable ID	homologs
ogarnettii_homolog_chromosome	Bushbaby chromosome/scaffold name	homologs
ogarnettii_homolog_chrom_start	Bushbaby chromosome/scaffold start (bp)	homologs
ogarnettii_homolog_chrom_end	Bushbaby chromosome/scaffold end (bp)	homologs
ogarnettii_homolog_canonical_transcript_protein	Query protein or transcript ID	homologs
ogarnettii_homolog_subtype	Last common ancestor with Bushbaby	homologs
ogarnettii_homolog_orthology_type	Bushbaby homology type	homologs
ogarnettii_homolog_perc_id	%id. target Bushbaby gene identical to query gene	homologs
ogarnettii_homolog_perc_id_r1	%id. query gene identical to target Bushbaby gene	homologs
ogarnettii_homolog_goc_score	Bushbaby Gene-order conservation score	homologs
ogarnettii_homolog_wga_coverage	Bushbaby Whole-genome alignment coverage	homologs
ogarnettii_homolog_dn	dN with Bushbaby	homologs
ogarnettii_homolog_ds	dS with Bushbaby	homologs
ogarnettii_homolog_orthology_confidence	Bushbaby orthology confidence [0 low, 1 high]	homologs
cintestinalis_homolog_ensembl_gene	C.intestinalis gene stable ID	homologs
cintestinalis_homolog_associated_gene_name	C.intestinalis gene name	homologs
cintestinalis_homolog_ensembl_peptide	C.intestinalis protein or transcript stable ID	homologs
cintestinalis_homolog_chromosome	C.intestinalis chromosome/scaffold name	homologs
cintestinalis_homolog_chrom_start	C.intestinalis chromosome/scaffold start (bp)	homologs
cintestinalis_homolog_chrom_end	C.intestinalis chromosome/scaffold end (bp)	homologs
cintestinalis_homolog_canonical_transcript_protein	Query protein or transcript ID	homologs
cintestinalis_homolog_subtype	Last common ancestor with C.intestinalis	homologs
cintestinalis_homolog_orthology_type	C.intestinalis homology type	homologs
cintestinalis_homolog_perc_id	%id. target C.intestinalis gene identical to query gene	homologs
cintestinalis_homolog_perc_id_r1	%id. query gene identical to target C.intestinalis gene	homologs
cintestinalis_homolog_goc_score	C.intestinalis Gene-order conservation score	homologs
cintestinalis_homolog_wga_coverage	C.intestinalis Whole-genome alignment coverage	homologs
cintestinalis_homolog_dn	dN with C.intestinalis	homologs
cintestinalis_homolog_ds	dS with C.intestinalis	homologs
cintestinalis_homolog_orthology_confidence	C.intestinalis orthology confidence [0 low, 1 high]	homologs
csavignyi_homolog_ensembl_gene	C.savignyi gene stable ID	homologs
csavignyi_homolog_associated_gene_name	C.savignyi gene name	homologs
csavignyi_homolog_ensembl_peptide	C.savignyi protein or transcript stable ID	homologs
csavignyi_homolog_chromosome	C.savignyi chromosome/scaffold name	homologs
csavignyi_homolog_chrom_start	C.savignyi chromosome/scaffold start (bp)	homologs
csavignyi_homolog_chrom_end	C.savignyi chromosome/scaffold end (bp)	homologs
csavignyi_homolog_canonical_transcript_protein	Query protein or transcript ID	homologs
csavignyi_homolog_subtype	Last common ancestor with C.savignyi	homologs
csavignyi_homolog_orthology_type	C.savignyi homology type	homologs
csavignyi_homolog_perc_id	%id. target C.savignyi gene identical to query gene	homologs
csavignyi_homolog_perc_id_r1	%id. query gene identical to target C.savignyi gene	homologs
csavignyi_homolog_goc_score	C.savignyi Gene-order conservation score	homologs
csavignyi_homolog_wga_coverage	C.savignyi Whole-genome alignment coverage	homologs
csavignyi_homolog_dn	dN with C.savignyi	homologs
csavignyi_homolog_ds	dS with C.savignyi	homologs
csavignyi_homolog_orthology_confidence	C.savignyi orthology confidence [0 low, 1 high]	homologs
celegans_homolog_ensembl_gene	Caenorhabditis elegans gene stable ID	homologs
celegans_homolog_associated_gene_name	Caenorhabditis elegans gene name	homologs
celegans_homolog_ensembl_peptide	Caenorhabditis elegans protein or transcript stable ID	homologs
celegans_homolog_chromosome	Caenorhabditis elegans chromosome/scaffold name	homologs
celegans_homolog_chrom_start	Caenorhabditis elegans chromosome/scaffold start (bp)	homologs
celegans_homolog_chrom_end	Caenorhabditis elegans chromosome/scaffold end (bp)	homologs
celegans_homolog_canonical_transcript_protein	Query protein or transcript ID	homologs
celegans_homolog_subtype	Last common ancestor with Caenorhabditis elegans	homologs
celegans_homolog_orthology_type	Caenorhabditis elegans homology type	homologs
celegans_homolog_perc_id	%id. target Caenorhabditis elegans gene identical to query gene	homologs
celegans_homolog_perc_id_r1	%id. query gene identical to target Caenorhabditis elegans gene	homologs
celegans_homolog_goc_score	Caenorhabditis elegans Gene-order conservation score	homologs
celegans_homolog_wga_coverage	Caenorhabditis elegans Whole-genome alignment coverage	homologs
celegans_homolog_dn	dN with Caenorhabditis elegans	homologs
celegans_homolog_ds	dS with Caenorhabditis elegans	homologs
celegans_homolog_orthology_confidence	Caenorhabditis elegans orthology confidence [0 low, 1 high]	homologs
fcatus_homolog_ensembl_gene	Cat gene stable ID	homologs
fcatus_homolog_associated_gene_name	Cat gene name	homologs
fcatus_homolog_ensembl_peptide	Cat protein or transcript stable ID	homologs
fcatus_homolog_chromosome	Cat chromosome/scaffold name	homologs
fcatus_homolog_chrom_start	Cat chromosome/scaffold start (bp)	homologs
fcatus_homolog_chrom_end	Cat chromosome/scaffold end (bp)	homologs
fcatus_homolog_canonical_transcript_protein	Query protein or transcript ID	homologs
fcatus_homolog_subtype	Last common ancestor with Cat	homologs
fcatus_homolog_orthology_type	Cat homology type	homologs
fcatus_homolog_perc_id	%id. target Cat gene identical to query gene	homologs
fcatus_homolog_perc_id_r1	%id. query gene identical to target Cat gene	homologs
fcatus_homolog_goc_score	Cat Gene-order conservation score	homologs
fcatus_homolog_wga_coverage	Cat Whole-genome alignment coverage	homologs
fcatus_homolog_dn	dN with Cat	homologs
fcatus_homolog_ds	dS with Cat	homologs
fcatus_homolog_orthology_confidence	Cat orthology confidence [0 low, 1 high]	homologs
amexicanus_homolog_ensembl_gene	Cave fish gene stable ID	homologs
amexicanus_homolog_associated_gene_name	Cave fish gene name	homologs
amexicanus_homolog_ensembl_peptide	Cave fish protein or transcript stable ID	homologs
amexicanus_homolog_chromosome	Cave fish chromosome/scaffold name	homologs
amexicanus_homolog_chrom_start	Cave fish chromosome/scaffold start (bp)	homologs
amexicanus_homolog_chrom_end	Cave fish chromosome/scaffold end (bp)	homologs
amexicanus_homolog_canonical_transcript_protein	Query protein or transcript ID	homologs
amexicanus_homolog_subtype	Last common ancestor with Cave fish	homologs
amexicanus_homolog_orthology_type	Cave fish homology type	homologs
amexicanus_homolog_perc_id	%id. target Cave fish gene identical to query gene	homologs
amexicanus_homolog_perc_id_r1	%id. query gene identical to target Cave fish gene	homologs
amexicanus_homolog_goc_score	Cave fish Gene-order conservation score	homologs
amexicanus_homolog_wga_coverage	Cave fish Whole-genome alignment coverage	homologs
amexicanus_homolog_dn	dN with Cave fish	homologs
amexicanus_homolog_ds	dS with Cave fish	homologs
amexicanus_homolog_orthology_confidence	Cave fish orthology confidence [0 low, 1 high]	homologs
ggallus_homolog_ensembl_gene	Chicken gene stable ID	homologs
ggallus_homolog_associated_gene_name	Chicken gene name	homologs
ggallus_homolog_ensembl_peptide	Chicken protein or transcript stable ID	homologs
ggallus_homolog_chromosome	Chicken chromosome/scaffold name	homologs
ggallus_homolog_chrom_start	Chicken chromosome/scaffold start (bp)	homologs
ggallus_homolog_chrom_end	Chicken chromosome/scaffold end (bp)	homologs
ggallus_homolog_canonical_transcript_protein	Query protein or transcript ID	homologs
ggallus_homolog_subtype	Last common ancestor with Chicken	homologs
ggallus_homolog_orthology_type	Chicken homology type	homologs
ggallus_homolog_perc_id	%id. target Chicken gene identical to query gene	homologs
ggallus_homolog_perc_id_r1	%id. query gene identical to target Chicken gene	homologs
ggallus_homolog_goc_score	Chicken Gene-order conservation score	homologs
ggallus_homolog_wga_coverage	Chicken Whole-genome alignment coverage	homologs
ggallus_homolog_dn	dN with Chicken	homologs
ggallus_homolog_ds	dS with Chicken	homologs
ggallus_homolog_orthology_confidence	Chicken orthology confidence [0 low, 1 high]	homologs
ptroglodytes_homolog_ensembl_gene	Chimpanzee gene stable ID	homologs
ptroglodytes_homolog_associated_gene_name	Chimpanzee gene name	homologs
ptroglodytes_homolog_ensembl_peptide	Chimpanzee protein or transcript stable ID	homologs
ptroglodytes_homolog_chromosome	Chimpanzee chromosome/scaffold name	homologs
ptroglodytes_homolog_chrom_start	Chimpanzee chromosome/scaffold start (bp)	homologs
ptroglodytes_homolog_chrom_end	Chimpanzee chromosome/scaffold end (bp)	homologs
ptroglodytes_homolog_canonical_transcript_protein	Query protein or transcript ID	homologs
ptroglodytes_homolog_subtype	Last common ancestor with Chimpanzee	homologs
ptroglodytes_homolog_orthology_type	Chimpanzee homology type	homologs
ptroglodytes_homolog_perc_id	%id. target Chimpanzee gene identical to query gene	homologs
ptroglodytes_homolog_perc_id_r1	%id. query gene identical to target Chimpanzee gene	homologs
ptroglodytes_homolog_goc_score	Chimpanzee Gene-order conservation score	homologs
ptroglodytes_homolog_wga_coverage	Chimpanzee Whole-genome alignment coverage	homologs
ptroglodytes_homolog_dn	dN with Chimpanzee	homologs
ptroglodytes_homolog_ds	dS with Chimpanzee	homologs
ptroglodytes_homolog_orthology_confidence	Chimpanzee orthology confidence [0 low, 1 high]	homologs
psinensis_homolog_ensembl_gene	Chinese softshell turtle gene stable ID	homologs
psinensis_homolog_associated_gene_name	Chinese softshell turtle gene name	homologs
psinensis_homolog_ensembl_peptide	Chinese softshell turtle protein or transcript stable ID	homologs
psinensis_homolog_chromosome	Chinese softshell turtle chromosome/scaffold name	homologs
psinensis_homolog_chrom_start	Chinese softshell turtle chromosome/scaffold start (bp)	homologs
psinensis_homolog_chrom_end	Chinese softshell turtle chromosome/scaffold end (bp)	homologs
psinensis_homolog_canonical_transcript_protein	Query protein or transcript ID	homologs
psinensis_homolog_subtype	Last common ancestor with Chinese softshell turtle	homologs
psinensis_homolog_orthology_type	Chinese softshell turtle homology type	homologs
psinensis_homolog_perc_id	%id. target Chinese softshell turtle gene identical to query gene	homologs
psinensis_homolog_perc_id_r1	%id. query gene identical to target Chinese softshell turtle gene	homologs
psinensis_homolog_goc_score	Chinese softshell turtle Gene-order conservation score	homologs
psinensis_homolog_wga_coverage	Chinese softshell turtle Whole-genome alignment coverage	homologs
psinensis_homolog_dn	dN with Chinese softshell turtle	homologs
psinensis_homolog_ds	dS with Chinese softshell turtle	homologs
psinensis_homolog_orthology_confidence	Chinese softshell turtle orthology confidence [0 low, 1 high]	homologs
gmorhua_homolog_ensembl_gene	Cod gene stable ID	homologs
gmorhua_homolog_associated_gene_name	Cod gene name	homologs
gmorhua_homolog_ensembl_peptide	Cod protein or transcript stable ID	homologs
gmorhua_homolog_chromosome	Cod chromosome/scaffold name	homologs
gmorhua_homolog_chrom_start	Cod chromosome/scaffold start (bp)	homologs
gmorhua_homolog_chrom_end	Cod chromosome/scaffold end (bp)	homologs
gmorhua_homolog_canonical_transcript_protein	Query protein or transcript ID	homologs
gmorhua_homolog_subtype	Last common ancestor with Cod	homologs
gmorhua_homolog_orthology_type	Cod homology type	homologs
gmorhua_homolog_perc_id	%id. target Cod gene identical to query gene	homologs
gmorhua_homolog_perc_id_r1	%id. query gene identical to target Cod gene	homologs
gmorhua_homolog_goc_score	Cod Gene-order conservation score	homologs
gmorhua_homolog_wga_coverage	Cod Whole-genome alignment coverage	homologs
gmorhua_homolog_dn	dN with Cod	homologs
gmorhua_homolog_ds	dS with Cod	homologs
gmorhua_homolog_orthology_confidence	Cod orthology confidence [0 low, 1 high]	homologs
lchalumnae_homolog_ensembl_gene	Coelacanth gene stable ID	homologs
lchalumnae_homolog_associated_gene_name	Coelacanth gene name	homologs
lchalumnae_homolog_ensembl_peptide	Coelacanth protein or transcript stable ID	homologs
lchalumnae_homolog_chromosome	Coelacanth chromosome/scaffold name	homologs
lchalumnae_homolog_chrom_start	Coelacanth chromosome/scaffold start (bp)	homologs
lchalumnae_homolog_chrom_end	Coelacanth chromosome/scaffold end (bp)	homologs
lchalumnae_homolog_canonical_transcript_protein	Query protein or transcript ID	homologs
lchalumnae_homolog_subtype	Last common ancestor with Coelacanth	homologs
lchalumnae_homolog_orthology_type	Coelacanth homology type	homologs
lchalumnae_homolog_perc_id	%id. target Coelacanth gene identical to query gene	homologs
lchalumnae_homolog_perc_id_r1	%id. query gene identical to target Coelacanth gene	homologs
lchalumnae_homolog_goc_score	Coelacanth Gene-order conservation score	homologs
lchalumnae_homolog_wga_coverage	Coelacanth Whole-genome alignment coverage	homologs
lchalumnae_homolog_dn	dN with Coelacanth	homologs
lchalumnae_homolog_ds	dS with Coelacanth	homologs
lchalumnae_homolog_orthology_confidence	Coelacanth orthology confidence [0 low, 1 high]	homologs
btaurus_homolog_ensembl_gene	Cow gene stable ID	homologs
btaurus_homolog_associated_gene_name	Cow gene name	homologs
btaurus_homolog_ensembl_peptide	Cow protein or transcript stable ID	homologs
btaurus_homolog_chromosome	Cow chromosome/scaffold name	homologs
btaurus_homolog_chrom_start	Cow chromosome/scaffold start (bp)	homologs
btaurus_homolog_chrom_end	Cow chromosome/scaffold end (bp)	homologs
btaurus_homolog_canonical_transcript_protein	Query protein or transcript ID	homologs
btaurus_homolog_subtype	Last common ancestor with Cow	homologs
btaurus_homolog_orthology_type	Cow homology type	homologs
btaurus_homolog_perc_id	%id. target Cow gene identical to query gene	homologs
btaurus_homolog_perc_id_r1	%id. query gene identical to target Cow gene	homologs
btaurus_homolog_goc_score	Cow Gene-order conservation score	homologs
btaurus_homolog_wga_coverage	Cow Whole-genome alignment coverage	homologs
btaurus_homolog_dn	dN with Cow	homologs
btaurus_homolog_ds	dS with Cow	homologs
btaurus_homolog_orthology_confidence	Cow orthology confidence [0 low, 1 high]	homologs
cfamiliaris_homolog_ensembl_gene	Dog gene stable ID	homologs
cfamiliaris_homolog_associated_gene_name	Dog gene name	homologs
cfamiliaris_homolog_ensembl_peptide	Dog protein or transcript stable ID	homologs
cfamiliaris_homolog_chromosome	Dog chromosome/scaffold name	homologs
cfamiliaris_homolog_chrom_start	Dog chromosome/scaffold start (bp)	homologs
cfamiliaris_homolog_chrom_end	Dog chromosome/scaffold end (bp)	homologs
cfamiliaris_homolog_canonical_transcript_protein	Query protein or transcript ID	homologs
cfamiliaris_homolog_subtype	Last common ancestor with Dog	homologs
cfamiliaris_homolog_orthology_type	Dog homology type	homologs
cfamiliaris_homolog_perc_id	%id. target Dog gene identical to query gene	homologs
cfamiliaris_homolog_perc_id_r1	%id. query gene identical to target Dog gene	homologs
cfamiliaris_homolog_goc_score	Dog Gene-order conservation score	homologs
cfamiliaris_homolog_wga_coverage	Dog Whole-genome alignment coverage	homologs
cfamiliaris_homolog_dn	dN with Dog	homologs
cfamiliaris_homolog_ds	dS with Dog	homologs
cfamiliaris_homolog_orthology_confidence	Dog orthology confidence [0 low, 1 high]	homologs
ttruncatus_homolog_ensembl_gene	Dolphin gene stable ID	homologs
ttruncatus_homolog_associated_gene_name	Dolphin gene name	homologs
ttruncatus_homolog_ensembl_peptide	Dolphin protein or transcript stable ID	homologs
ttruncatus_homolog_chromosome	Dolphin chromosome/scaffold name	homologs
ttruncatus_homolog_chrom_start	Dolphin chromosome/scaffold start (bp)	homologs
ttruncatus_homolog_chrom_end	Dolphin chromosome/scaffold end (bp)	homologs
ttruncatus_homolog_canonical_transcript_protein	Query protein or transcript ID	homologs
ttruncatus_homolog_subtype	Last common ancestor with Dolphin	homologs
ttruncatus_homolog_orthology_type	Dolphin homology type	homologs
ttruncatus_homolog_perc_id	%id. target Dolphin gene identical to query gene	homologs
ttruncatus_homolog_perc_id_r1	%id. query gene identical to target Dolphin gene	homologs
ttruncatus_homolog_goc_score	Dolphin Gene-order conservation score	homologs
ttruncatus_homolog_wga_coverage	Dolphin Whole-genome alignment coverage	homologs
ttruncatus_homolog_dn	dN with Dolphin	homologs
ttruncatus_homolog_ds	dS with Dolphin	homologs
ttruncatus_homolog_orthology_confidence	Dolphin orthology confidence [0 low, 1 high]	homologs
aplatyrhynchos_homolog_ensembl_gene	Duck gene stable ID	homologs
aplatyrhynchos_homolog_associated_gene_name	Duck gene name	homologs
aplatyrhynchos_homolog_ensembl_peptide	Duck protein or transcript stable ID	homologs
aplatyrhynchos_homolog_chromosome	Duck chromosome/scaffold name	homologs
aplatyrhynchos_homolog_chrom_start	Duck chromosome/scaffold start (bp)	homologs
aplatyrhynchos_homolog_chrom_end	Duck chromosome/scaffold end (bp)	homologs
aplatyrhynchos_homolog_canonical_transcript_protein	Query protein or transcript ID	homologs
aplatyrhynchos_homolog_subtype	Last common ancestor with Duck	homologs
aplatyrhynchos_homolog_orthology_type	Duck homology type	homologs
aplatyrhynchos_homolog_perc_id	%id. target Duck gene identical to query gene	homologs
aplatyrhynchos_homolog_perc_id_r1	%id. query gene identical to target Duck gene	homologs
aplatyrhynchos_homolog_goc_score	Duck Gene-order conservation score	homologs
aplatyrhynchos_homolog_wga_coverage	Duck Whole-genome alignment coverage	homologs
aplatyrhynchos_homolog_dn	dN with Duck	homologs
aplatyrhynchos_homolog_ds	dS with Duck	homologs
aplatyrhynchos_homolog_orthology_confidence	Duck orthology confidence [0 low, 1 high]	homologs
lafricana_homolog_ensembl_gene	Elephant gene stable ID	homologs
lafricana_homolog_associated_gene_name	Elephant gene name	homologs
lafricana_homolog_ensembl_peptide	Elephant protein or transcript stable ID	homologs
lafricana_homolog_chromosome	Elephant chromosome/scaffold name	homologs
lafricana_homolog_chrom_start	Elephant chromosome/scaffold start (bp)	homologs
lafricana_homolog_chrom_end	Elephant chromosome/scaffold end (bp)	homologs
lafricana_homolog_canonical_transcript_protein	Query protein or transcript ID	homologs
lafricana_homolog_subtype	Last common ancestor with Elephant	homologs
lafricana_homolog_orthology_type	Elephant homology type	homologs
lafricana_homolog_perc_id	%id. target Elephant gene identical to query gene	homologs
lafricana_homolog_perc_id_r1	%id. query gene identical to target Elephant gene	homologs
lafricana_homolog_goc_score	Elephant Gene-order conservation score	homologs
lafricana_homolog_wga_coverage	Elephant Whole-genome alignment coverage	homologs
lafricana_homolog_dn	dN with Elephant	homologs
lafricana_homolog_ds	dS with Elephant	homologs
lafricana_homolog_orthology_confidence	Elephant orthology confidence [0 low, 1 high]	homologs
mfuro_homolog_ensembl_gene	Ferret gene stable ID	homologs
mfuro_homolog_associated_gene_name	Ferret gene name	homologs
mfuro_homolog_ensembl_peptide	Ferret protein or transcript stable ID	homologs
mfuro_homolog_chromosome	Ferret chromosome/scaffold name	homologs
mfuro_homolog_chrom_start	Ferret chromosome/scaffold start (bp)	homologs
mfuro_homolog_chrom_end	Ferret chromosome/scaffold end (bp)	homologs
mfuro_homolog_canonical_transcript_protein	Query protein or transcript ID	homologs
mfuro_homolog_subtype	Last common ancestor with Ferret	homologs
mfuro_homolog_orthology_type	Ferret homology type	homologs
mfuro_homolog_perc_id	%id. target Ferret gene identical to query gene	homologs
mfuro_homolog_perc_id_r1	%id. query gene identical to target Ferret gene	homologs
mfuro_homolog_goc_score	Ferret Gene-order conservation score	homologs
mfuro_homolog_wga_coverage	Ferret Whole-genome alignment coverage	homologs
mfuro_homolog_dn	dN with Ferret	homologs
mfuro_homolog_ds	dS with Ferret	homologs
mfuro_homolog_orthology_confidence	Ferret orthology confidence [0 low, 1 high]	homologs
falbicollis_homolog_ensembl_gene	Flycatcher gene stable ID	homologs
falbicollis_homolog_associated_gene_name	Flycatcher gene name	homologs
falbicollis_homolog_ensembl_peptide	Flycatcher protein or transcript stable ID	homologs
falbicollis_homolog_chromosome	Flycatcher chromosome/scaffold name	homologs
falbicollis_homolog_chrom_start	Flycatcher chromosome/scaffold start (bp)	homologs
falbicollis_homolog_chrom_end	Flycatcher chromosome/scaffold end (bp)	homologs
falbicollis_homolog_canonical_transcript_protein	Query protein or transcript ID	homologs
falbicollis_homolog_subtype	Last common ancestor with Flycatcher	homologs
falbicollis_homolog_orthology_type	Flycatcher homology type	homologs
falbicollis_homolog_perc_id	%id. target Flycatcher gene identical to query gene	homologs
falbicollis_homolog_perc_id_r1	%id. query gene identical to target Flycatcher gene	homologs
falbicollis_homolog_goc_score	Flycatcher Gene-order conservation score	homologs
falbicollis_homolog_wga_coverage	Flycatcher Whole-genome alignment coverage	homologs
falbicollis_homolog_dn	dN with Flycatcher	homologs
falbicollis_homolog_ds	dS with Flycatcher	homologs
falbicollis_homolog_orthology_confidence	Flycatcher orthology confidence [0 low, 1 high]	homologs
dmelanogaster_homolog_ensembl_gene	Fruitfly gene stable ID	homologs
dmelanogaster_homolog_associated_gene_name	Fruitfly gene name	homologs
dmelanogaster_homolog_ensembl_peptide	Fruitfly protein or transcript stable ID	homologs
dmelanogaster_homolog_chromosome	Fruitfly chromosome/scaffold name	homologs
dmelanogaster_homolog_chrom_start	Fruitfly chromosome/scaffold start (bp)	homologs
dmelanogaster_homolog_chrom_end	Fruitfly chromosome/scaffold end (bp)	homologs
dmelanogaster_homolog_canonical_transcript_protein	Query protein or transcript ID	homologs
dmelanogaster_homolog_subtype	Last common ancestor with Fruitfly	homologs
dmelanogaster_homolog_orthology_type	Fruitfly homology type	homologs
dmelanogaster_homolog_perc_id	%id. target Fruitfly gene identical to query gene	homologs
dmelanogaster_homolog_perc_id_r1	%id. query gene identical to target Fruitfly gene	homologs
dmelanogaster_homolog_goc_score	Fruitfly Gene-order conservation score	homologs
dmelanogaster_homolog_wga_coverage	Fruitfly Whole-genome alignment coverage	homologs
dmelanogaster_homolog_dn	dN with Fruitfly	homologs
dmelanogaster_homolog_ds	dS with Fruitfly	homologs
dmelanogaster_homolog_orthology_confidence	Fruitfly orthology confidence [0 low, 1 high]	homologs
trubripes_homolog_ensembl_gene	Fugu gene stable ID	homologs
trubripes_homolog_associated_gene_name	Fugu gene name	homologs
trubripes_homolog_ensembl_peptide	Fugu protein or transcript stable ID	homologs
trubripes_homolog_chromosome	Fugu chromosome/scaffold name	homologs
trubripes_homolog_chrom_start	Fugu chromosome/scaffold start (bp)	homologs
trubripes_homolog_chrom_end	Fugu chromosome/scaffold end (bp)	homologs
trubripes_homolog_canonical_transcript_protein	Query protein or transcript ID	homologs
trubripes_homolog_subtype	Last common ancestor with Fugu	homologs
trubripes_homolog_orthology_type	Fugu homology type	homologs
trubripes_homolog_perc_id	%id. target Fugu gene identical to query gene	homologs
trubripes_homolog_perc_id_r1	%id. query gene identical to target Fugu gene	homologs
trubripes_homolog_goc_score	Fugu Gene-order conservation score	homologs
trubripes_homolog_wga_coverage	Fugu Whole-genome alignment coverage	homologs
trubripes_homolog_dn	dN with Fugu	homologs
trubripes_homolog_ds	dS with Fugu	homologs
trubripes_homolog_orthology_confidence	Fugu orthology confidence [0 low, 1 high]	homologs
nleucogenys_homolog_ensembl_gene	Gibbon gene stable ID	homologs
nleucogenys_homolog_associated_gene_name	Gibbon gene name	homologs
nleucogenys_homolog_ensembl_peptide	Gibbon protein or transcript stable ID	homologs
nleucogenys_homolog_chromosome	Gibbon chromosome/scaffold name	homologs
nleucogenys_homolog_chrom_start	Gibbon chromosome/scaffold start (bp)	homologs
nleucogenys_homolog_chrom_end	Gibbon chromosome/scaffold end (bp)	homologs
nleucogenys_homolog_canonical_transcript_protein	Query protein or transcript ID	homologs
nleucogenys_homolog_subtype	Last common ancestor with Gibbon	homologs
nleucogenys_homolog_orthology_type	Gibbon homology type	homologs
nleucogenys_homolog_perc_id	%id. target Gibbon gene identical to query gene	homologs
nleucogenys_homolog_perc_id_r1	%id. query gene identical to target Gibbon gene	homologs
nleucogenys_homolog_goc_score	Gibbon Gene-order conservation score	homologs
nleucogenys_homolog_wga_coverage	Gibbon Whole-genome alignment coverage	homologs
nleucogenys_homolog_dn	dN with Gibbon	homologs
nleucogenys_homolog_ds	dS with Gibbon	homologs
nleucogenys_homolog_orthology_confidence	Gibbon orthology confidence [0 low, 1 high]	homologs
ggorilla_homolog_ensembl_gene	Gorilla gene stable ID	homologs
ggorilla_homolog_associated_gene_name	Gorilla gene name	homologs
ggorilla_homolog_ensembl_peptide	Gorilla protein or transcript stable ID	homologs
ggorilla_homolog_chromosome	Gorilla chromosome/scaffold name	homologs
ggorilla_homolog_chrom_start	Gorilla chromosome/scaffold start (bp)	homologs
ggorilla_homolog_chrom_end	Gorilla chromosome/scaffold end (bp)	homologs
ggorilla_homolog_canonical_transcript_protein	Query protein or transcript ID	homologs
ggorilla_homolog_subtype	Last common ancestor with Gorilla	homologs
ggorilla_homolog_orthology_type	Gorilla homology type	homologs
ggorilla_homolog_perc_id	%id. target Gorilla gene identical to query gene	homologs
ggorilla_homolog_perc_id_r1	%id. query gene identical to target Gorilla gene	homologs
ggorilla_homolog_goc_score	Gorilla Gene-order conservation score	homologs
ggorilla_homolog_wga_coverage	Gorilla Whole-genome alignment coverage	homologs
ggorilla_homolog_dn	dN with Gorilla	homologs
ggorilla_homolog_ds	dS with Gorilla	homologs
ggorilla_homolog_orthology_confidence	Gorilla orthology confidence [0 low, 1 high]	homologs
cporcellus_homolog_ensembl_gene	Guinea Pig gene stable ID	homologs
cporcellus_homolog_associated_gene_name	Guinea Pig gene name	homologs
cporcellus_homolog_ensembl_peptide	Guinea Pig protein or transcript stable ID	homologs
cporcellus_homolog_chromosome	Guinea Pig chromosome/scaffold name	homologs
cporcellus_homolog_chrom_start	Guinea Pig chromosome/scaffold start (bp)	homologs
cporcellus_homolog_chrom_end	Guinea Pig chromosome/scaffold end (bp)	homologs
cporcellus_homolog_canonical_transcript_protein	Query protein or transcript ID	homologs
cporcellus_homolog_subtype	Last common ancestor with Guinea Pig	homologs
cporcellus_homolog_orthology_type	Guinea Pig homology type	homologs
cporcellus_homolog_perc_id	%id. target Guinea Pig gene identical to query gene	homologs
cporcellus_homolog_perc_id_r1	%id. query gene identical to target Guinea Pig gene	homologs
cporcellus_homolog_goc_score	Guinea Pig Gene-order conservation score	homologs
cporcellus_homolog_wga_coverage	Guinea Pig Whole-genome alignment coverage	homologs
cporcellus_homolog_dn	dN with Guinea Pig	homologs
cporcellus_homolog_ds	dS with Guinea Pig	homologs
cporcellus_homolog_orthology_confidence	Guinea Pig orthology confidence [0 low, 1 high]	homologs
eeuropaeus_homolog_ensembl_gene	Hedgehog gene stable ID	homologs
eeuropaeus_homolog_associated_gene_name	Hedgehog gene name	homologs
eeuropaeus_homolog_ensembl_peptide	Hedgehog protein or transcript stable ID	homologs
eeuropaeus_homolog_chromosome	Hedgehog chromosome/scaffold name	homologs
eeuropaeus_homolog_chrom_start	Hedgehog chromosome/scaffold start (bp)	homologs
eeuropaeus_homolog_chrom_end	Hedgehog chromosome/scaffold end (bp)	homologs
eeuropaeus_homolog_canonical_transcript_protein	Query protein or transcript ID	homologs
eeuropaeus_homolog_subtype	Last common ancestor with Hedgehog	homologs
eeuropaeus_homolog_orthology_type	Hedgehog homology type	homologs
eeuropaeus_homolog_perc_id	%id. target Hedgehog gene identical to query gene	homologs
eeuropaeus_homolog_perc_id_r1	%id. query gene identical to target Hedgehog gene	homologs
eeuropaeus_homolog_goc_score	Hedgehog Gene-order conservation score	homologs
eeuropaeus_homolog_wga_coverage	Hedgehog Whole-genome alignment coverage	homologs
eeuropaeus_homolog_dn	dN with Hedgehog	homologs
eeuropaeus_homolog_ds	dS with Hedgehog	homologs
eeuropaeus_homolog_orthology_confidence	Hedgehog orthology confidence [0 low, 1 high]	homologs
ecaballus_homolog_ensembl_gene	Horse gene stable ID	homologs
ecaballus_homolog_associated_gene_name	Horse gene name	homologs
ecaballus_homolog_ensembl_peptide	Horse protein or transcript stable ID	homologs
ecaballus_homolog_chromosome	Horse chromosome/scaffold name	homologs
ecaballus_homolog_chrom_start	Horse chromosome/scaffold start (bp)	homologs
ecaballus_homolog_chrom_end	Horse chromosome/scaffold end (bp)	homologs
ecaballus_homolog_canonical_transcript_protein	Query protein or transcript ID	homologs
ecaballus_homolog_subtype	Last common ancestor with Horse	homologs
ecaballus_homolog_orthology_type	Horse homology type	homologs
ecaballus_homolog_perc_id	%id. target Horse gene identical to query gene	homologs
ecaballus_homolog_perc_id_r1	%id. query gene identical to target Horse gene	homologs
ecaballus_homolog_goc_score	Horse Gene-order conservation score	homologs
ecaballus_homolog_wga_coverage	Horse Whole-genome alignment coverage	homologs
ecaballus_homolog_dn	dN with Horse	homologs
ecaballus_homolog_ds	dS with Horse	homologs
ecaballus_homolog_orthology_confidence	Horse orthology confidence [0 low, 1 high]	homologs
pcapensis_homolog_ensembl_gene	Hyrax gene stable ID	homologs
pcapensis_homolog_associated_gene_name	Hyrax gene name	homologs
pcapensis_homolog_ensembl_peptide	Hyrax protein or transcript stable ID	homologs
pcapensis_homolog_chromosome	Hyrax chromosome/scaffold name	homologs
pcapensis_homolog_chrom_start	Hyrax chromosome/scaffold start (bp)	homologs
pcapensis_homolog_chrom_end	Hyrax chromosome/scaffold end (bp)	homologs
pcapensis_homolog_canonical_transcript_protein	Query protein or transcript ID	homologs
pcapensis_homolog_subtype	Last common ancestor with Hyrax	homologs
pcapensis_homolog_orthology_type	Hyrax homology type	homologs
pcapensis_homolog_perc_id	%id. target Hyrax gene identical to query gene	homologs
pcapensis_homolog_perc_id_r1	%id. query gene identical to target Hyrax gene	homologs
pcapensis_homolog_goc_score	Hyrax Gene-order conservation score	homologs
pcapensis_homolog_wga_coverage	Hyrax Whole-genome alignment coverage	homologs
pcapensis_homolog_dn	dN with Hyrax	homologs
pcapensis_homolog_ds	dS with Hyrax	homologs
pcapensis_homolog_orthology_confidence	Hyrax orthology confidence [0 low, 1 high]	homologs
dordii_homolog_ensembl_gene	Kangaroo rat gene stable ID	homologs
dordii_homolog_associated_gene_name	Kangaroo rat gene name	homologs
dordii_homolog_ensembl_peptide	Kangaroo rat protein or transcript stable ID	homologs
dordii_homolog_chromosome	Kangaroo rat chromosome/scaffold name	homologs
dordii_homolog_chrom_start	Kangaroo rat chromosome/scaffold start (bp)	homologs
dordii_homolog_chrom_end	Kangaroo rat chromosome/scaffold end (bp)	homologs
dordii_homolog_canonical_transcript_protein	Query protein or transcript ID	homologs
dordii_homolog_subtype	Last common ancestor with Kangaroo rat	homologs
dordii_homolog_orthology_type	Kangaroo rat homology type	homologs
dordii_homolog_perc_id	%id. target Kangaroo rat gene identical to query gene	homologs
dordii_homolog_perc_id_r1	%id. query gene identical to target Kangaroo rat gene	homologs
dordii_homolog_goc_score	Kangaroo rat Gene-order conservation score	homologs
dordii_homolog_wga_coverage	Kangaroo rat Whole-genome alignment coverage	homologs
dordii_homolog_dn	dN with Kangaroo rat	homologs
dordii_homolog_ds	dS with Kangaroo rat	homologs
dordii_homolog_orthology_confidence	Kangaroo rat orthology confidence [0 low, 1 high]	homologs
pmarinus_homolog_ensembl_gene	Lamprey gene stable ID	homologs
pmarinus_homolog_associated_gene_name	Lamprey gene name	homologs
pmarinus_homolog_ensembl_peptide	Lamprey protein or transcript stable ID	homologs
pmarinus_homolog_chromosome	Lamprey chromosome/scaffold name	homologs
pmarinus_homolog_chrom_start	Lamprey chromosome/scaffold start (bp)	homologs
pmarinus_homolog_chrom_end	Lamprey chromosome/scaffold end (bp)	homologs
pmarinus_homolog_canonical_transcript_protein	Query protein or transcript ID	homologs
pmarinus_homolog_subtype	Last common ancestor with Lamprey	homologs
pmarinus_homolog_orthology_type	Lamprey homology type	homologs
pmarinus_homolog_perc_id	%id. target Lamprey gene identical to query gene	homologs
pmarinus_homolog_perc_id_r1	%id. query gene identical to target Lamprey gene	homologs
pmarinus_homolog_goc_score	Lamprey Gene-order conservation score	homologs
pmarinus_homolog_wga_coverage	Lamprey Whole-genome alignment coverage	homologs
pmarinus_homolog_dn	dN with Lamprey	homologs
pmarinus_homolog_ds	dS with Lamprey	homologs
pmarinus_homolog_orthology_confidence	Lamprey orthology confidence [0 low, 1 high]	homologs
etelfairi_homolog_ensembl_gene	Lesser hedgehog tenrec gene stable ID	homologs
etelfairi_homolog_associated_gene_name	Lesser hedgehog tenrec gene name	homologs
etelfairi_homolog_ensembl_peptide	Lesser hedgehog tenrec protein or transcript stable ID	homologs
etelfairi_homolog_chromosome	Lesser hedgehog tenrec chromosome/scaffold name	homologs
etelfairi_homolog_chrom_start	Lesser hedgehog tenrec chromosome/scaffold start (bp)	homologs
etelfairi_homolog_chrom_end	Lesser hedgehog tenrec chromosome/scaffold end (bp)	homologs
etelfairi_homolog_canonical_transcript_protein	Query protein or transcript ID	homologs
etelfairi_homolog_subtype	Last common ancestor with Lesser hedgehog tenrec	homologs
etelfairi_homolog_orthology_type	Lesser hedgehog tenrec homology type	homologs
etelfairi_homolog_perc_id	%id. target Lesser hedgehog tenrec gene identical to query gene	homologs
etelfairi_homolog_perc_id_r1	%id. query gene identical to target Lesser hedgehog tenrec gene	homologs
etelfairi_homolog_goc_score	Lesser hedgehog tenrec Gene-order conservation score	homologs
etelfairi_homolog_wga_coverage	Lesser hedgehog tenrec Whole-genome alignment coverage	homologs
etelfairi_homolog_dn	dN with Lesser hedgehog tenrec	homologs
etelfairi_homolog_ds	dS with Lesser hedgehog tenrec	homologs
etelfairi_homolog_orthology_confidence	Lesser hedgehog tenrec orthology confidence [0 low, 1 high]	homologs
mmulatta_homolog_ensembl_gene	Macaque gene stable ID	homologs
mmulatta_homolog_associated_gene_name	Macaque gene name	homologs
mmulatta_homolog_ensembl_peptide	Macaque protein or transcript stable ID	homologs
mmulatta_homolog_chromosome	Macaque chromosome/scaffold name	homologs
mmulatta_homolog_chrom_start	Macaque chromosome/scaffold start (bp)	homologs
mmulatta_homolog_chrom_end	Macaque chromosome/scaffold end (bp)	homologs
mmulatta_homolog_canonical_transcript_protein	Query protein or transcript ID	homologs
mmulatta_homolog_subtype	Last common ancestor with Macaque	homologs
mmulatta_homolog_orthology_type	Macaque homology type	homologs
mmulatta_homolog_perc_id	%id. target Macaque gene identical to query gene	homologs
mmulatta_homolog_perc_id_r1	%id. query gene identical to target Macaque gene	homologs
mmulatta_homolog_goc_score	Macaque Gene-order conservation score	homologs
mmulatta_homolog_wga_coverage	Macaque Whole-genome alignment coverage	homologs
mmulatta_homolog_dn	dN with Macaque	homologs
mmulatta_homolog_ds	dS with Macaque	homologs
mmulatta_homolog_orthology_confidence	Macaque orthology confidence [0 low, 1 high]	homologs
cjacchus_homolog_ensembl_gene	Marmoset gene stable ID	homologs
cjacchus_homolog_associated_gene_name	Marmoset gene name	homologs
cjacchus_homolog_ensembl_peptide	Marmoset protein or transcript stable ID	homologs
cjacchus_homolog_chromosome	Marmoset chromosome/scaffold name	homologs
cjacchus_homolog_chrom_start	Marmoset chromosome/scaffold start (bp)	homologs
cjacchus_homolog_chrom_end	Marmoset chromosome/scaffold end (bp)	homologs
cjacchus_homolog_canonical_transcript_protein	Query protein or transcript ID	homologs
cjacchus_homolog_subtype	Last common ancestor with Marmoset	homologs
cjacchus_homolog_orthology_type	Marmoset homology type	homologs
cjacchus_homolog_perc_id	%id. target Marmoset gene identical to query gene	homologs
cjacchus_homolog_perc_id_r1	%id. query gene identical to target Marmoset gene	homologs
cjacchus_homolog_goc_score	Marmoset Gene-order conservation score	homologs
cjacchus_homolog_wga_coverage	Marmoset Whole-genome alignment coverage	homologs
cjacchus_homolog_dn	dN with Marmoset	homologs
cjacchus_homolog_ds	dS with Marmoset	homologs
cjacchus_homolog_orthology_confidence	Marmoset orthology confidence [0 low, 1 high]	homologs
olatipes_homolog_ensembl_gene	Medaka gene stable ID	homologs
olatipes_homolog_associated_gene_name	Medaka gene name	homologs
olatipes_homolog_ensembl_peptide	Medaka protein or transcript stable ID	homologs
olatipes_homolog_chromosome	Medaka chromosome/scaffold name	homologs
olatipes_homolog_chrom_start	Medaka chromosome/scaffold start (bp)	homologs
olatipes_homolog_chrom_end	Medaka chromosome/scaffold end (bp)	homologs
olatipes_homolog_canonical_transcript_protein	Query protein or transcript ID	homologs
olatipes_homolog_subtype	Last common ancestor with Medaka	homologs
olatipes_homolog_orthology_type	Medaka homology type	homologs
olatipes_homolog_perc_id	%id. target Medaka gene identical to query gene	homologs
olatipes_homolog_perc_id_r1	%id. query gene identical to target Medaka gene	homologs
olatipes_homolog_goc_score	Medaka Gene-order conservation score	homologs
olatipes_homolog_wga_coverage	Medaka Whole-genome alignment coverage	homologs
olatipes_homolog_dn	dN with Medaka	homologs
olatipes_homolog_ds	dS with Medaka	homologs
olatipes_homolog_orthology_confidence	Medaka orthology confidence [0 low, 1 high]	homologs
pvampyrus_homolog_ensembl_gene	Megabat gene stable ID	homologs
pvampyrus_homolog_associated_gene_name	Megabat gene name	homologs
pvampyrus_homolog_ensembl_peptide	Megabat protein or transcript stable ID	homologs
pvampyrus_homolog_chromosome	Megabat chromosome/scaffold name	homologs
pvampyrus_homolog_chrom_start	Megabat chromosome/scaffold start (bp)	homologs
pvampyrus_homolog_chrom_end	Megabat chromosome/scaffold end (bp)	homologs
pvampyrus_homolog_canonical_transcript_protein	Query protein or transcript ID	homologs
pvampyrus_homolog_subtype	Last common ancestor with Megabat	homologs
pvampyrus_homolog_orthology_type	Megabat homology type	homologs
pvampyrus_homolog_perc_id	%id. target Megabat gene identical to query gene	homologs
pvampyrus_homolog_perc_id_r1	%id. query gene identical to target Megabat gene	homologs
pvampyrus_homolog_goc_score	Megabat Gene-order conservation score	homologs
pvampyrus_homolog_wga_coverage	Megabat Whole-genome alignment coverage	homologs
pvampyrus_homolog_dn	dN with Megabat	homologs
pvampyrus_homolog_ds	dS with Megabat	homologs
pvampyrus_homolog_orthology_confidence	Megabat orthology confidence [0 low, 1 high]	homologs
mlucifugus_homolog_ensembl_gene	Microbat gene stable ID	homologs
mlucifugus_homolog_associated_gene_name	Microbat gene name	homologs
mlucifugus_homolog_ensembl_peptide	Microbat protein or transcript stable ID	homologs
mlucifugus_homolog_chromosome	Microbat chromosome/scaffold name	homologs
mlucifugus_homolog_chrom_start	Microbat chromosome/scaffold start (bp)	homologs
mlucifugus_homolog_chrom_end	Microbat chromosome/scaffold end (bp)	homologs
mlucifugus_homolog_canonical_transcript_protein	Query protein or transcript ID	homologs
mlucifugus_homolog_subtype	Last common ancestor with Microbat	homologs
mlucifugus_homolog_orthology_type	Microbat homology type	homologs
mlucifugus_homolog_perc_id	%id. target Microbat gene identical to query gene	homologs
mlucifugus_homolog_perc_id_r1	%id. query gene identical to target Microbat gene	homologs
mlucifugus_homolog_goc_score	Microbat Gene-order conservation score	homologs
mlucifugus_homolog_wga_coverage	Microbat Whole-genome alignment coverage	homologs
mlucifugus_homolog_dn	dN with Microbat	homologs
mlucifugus_homolog_ds	dS with Microbat	homologs
mlucifugus_homolog_orthology_confidence	Microbat orthology confidence [0 low, 1 high]	homologs
mmusculus_homolog_ensembl_gene	Mouse gene stable ID	homologs
mmusculus_homolog_associated_gene_name	Mouse gene name	homologs
mmusculus_homolog_ensembl_peptide	Mouse protein or transcript stable ID	homologs
mmusculus_homolog_chromosome	Mouse chromosome/scaffold name	homologs
mmusculus_homolog_chrom_start	Mouse chromosome/scaffold start (bp)	homologs
mmusculus_homolog_chrom_end	Mouse chromosome/scaffold end (bp)	homologs
mmusculus_homolog_canonical_transcript_protein	Query protein or transcript ID	homologs
mmusculus_homolog_subtype	Last common ancestor with Mouse	homologs
mmusculus_homolog_orthology_type	Mouse homology type	homologs
mmusculus_homolog_perc_id	%id. target Mouse gene identical to query gene	homologs
mmusculus_homolog_perc_id_r1	%id. query gene identical to target Mouse gene	homologs
mmusculus_homolog_goc_score	Mouse Gene-order conservation score	homologs
mmusculus_homolog_wga_coverage	Mouse Whole-genome alignment coverage	homologs
mmusculus_homolog_dn	dN with Mouse	homologs
mmusculus_homolog_ds	dS with Mouse	homologs
mmusculus_homolog_orthology_confidence	Mouse orthology confidence [0 low, 1 high]	homologs
mmurinus_homolog_ensembl_gene	Mouse Lemur gene stable ID	homologs
mmurinus_homolog_associated_gene_name	Mouse Lemur gene name	homologs
mmurinus_homolog_ensembl_peptide	Mouse Lemur protein or transcript stable ID	homologs
mmurinus_homolog_chromosome	Mouse Lemur chromosome/scaffold name	homologs
mmurinus_homolog_chrom_start	Mouse Lemur chromosome/scaffold start (bp)	homologs
mmurinus_homolog_chrom_end	Mouse Lemur chromosome/scaffold end (bp)	homologs
mmurinus_homolog_canonical_transcript_protein	Query protein or transcript ID	homologs
mmurinus_homolog_subtype	Last common ancestor with Mouse Lemur	homologs
mmurinus_homolog_orthology_type	Mouse Lemur homology type	homologs
mmurinus_homolog_perc_id	%id. target Mouse Lemur gene identical to query gene	homologs
mmurinus_homolog_perc_id_r1	%id. query gene identical to target Mouse Lemur gene	homologs
mmurinus_homolog_goc_score	Mouse Lemur Gene-order conservation score	homologs
mmurinus_homolog_wga_coverage	Mouse Lemur Whole-genome alignment coverage	homologs
mmurinus_homolog_dn	dN with Mouse Lemur	homologs
mmurinus_homolog_ds	dS with Mouse Lemur	homologs
mmurinus_homolog_orthology_confidence	Mouse Lemur orthology confidence [0 low, 1 high]	homologs
mdomestica_homolog_ensembl_gene	Opossum gene stable ID	homologs
mdomestica_homolog_associated_gene_name	Opossum gene name	homologs
mdomestica_homolog_ensembl_peptide	Opossum protein or transcript stable ID	homologs
mdomestica_homolog_chromosome	Opossum chromosome/scaffold name	homologs
mdomestica_homolog_chrom_start	Opossum chromosome/scaffold start (bp)	homologs
mdomestica_homolog_chrom_end	Opossum chromosome/scaffold end (bp)	homologs
mdomestica_homolog_canonical_transcript_protein	Query protein or transcript ID	homologs
mdomestica_homolog_subtype	Last common ancestor with Opossum	homologs
mdomestica_homolog_orthology_type	Opossum homology type	homologs
mdomestica_homolog_perc_id	%id. target Opossum gene identical to query gene	homologs
mdomestica_homolog_perc_id_r1	%id. query gene identical to target Opossum gene	homologs
mdomestica_homolog_goc_score	Opossum Gene-order conservation score	homologs
mdomestica_homolog_wga_coverage	Opossum Whole-genome alignment coverage	homologs
mdomestica_homolog_dn	dN with Opossum	homologs
mdomestica_homolog_ds	dS with Opossum	homologs
mdomestica_homolog_orthology_confidence	Opossum orthology confidence [0 low, 1 high]	homologs
pabelii_homolog_ensembl_gene	Orangutan gene stable ID	homologs
pabelii_homolog_associated_gene_name	Orangutan gene name	homologs
pabelii_homolog_ensembl_peptide	Orangutan protein or transcript stable ID	homologs
pabelii_homolog_chromosome	Orangutan chromosome/scaffold name	homologs
pabelii_homolog_chrom_start	Orangutan chromosome/scaffold start (bp)	homologs
pabelii_homolog_chrom_end	Orangutan chromosome/scaffold end (bp)	homologs
pabelii_homolog_canonical_transcript_protein	Query protein or transcript ID	homologs
pabelii_homolog_subtype	Last common ancestor with Orangutan	homologs
pabelii_homolog_orthology_type	Orangutan homology type	homologs
pabelii_homolog_perc_id	%id. target Orangutan gene identical to query gene	homologs
pabelii_homolog_perc_id_r1	%id. query gene identical to target Orangutan gene	homologs
pabelii_homolog_goc_score	Orangutan Gene-order conservation score	homologs
pabelii_homolog_wga_coverage	Orangutan Whole-genome alignment coverage	homologs
pabelii_homolog_dn	dN with Orangutan	homologs
pabelii_homolog_ds	dS with Orangutan	homologs
pabelii_homolog_orthology_confidence	Orangutan orthology confidence [0 low, 1 high]	homologs
amelanoleuca_homolog_ensembl_gene	Panda gene stable ID	homologs
amelanoleuca_homolog_associated_gene_name	Panda gene name	homologs
amelanoleuca_homolog_ensembl_peptide	Panda protein or transcript stable ID	homologs
amelanoleuca_homolog_chromosome	Panda chromosome/scaffold name	homologs
amelanoleuca_homolog_chrom_start	Panda chromosome/scaffold start (bp)	homologs
amelanoleuca_homolog_chrom_end	Panda chromosome/scaffold end (bp)	homologs
amelanoleuca_homolog_canonical_transcript_protein	Query protein or transcript ID	homologs
amelanoleuca_homolog_subtype	Last common ancestor with Panda	homologs
amelanoleuca_homolog_orthology_type	Panda homology type	homologs
amelanoleuca_homolog_perc_id	%id. target Panda gene identical to query gene	homologs
amelanoleuca_homolog_perc_id_r1	%id. query gene identical to target Panda gene	homologs
amelanoleuca_homolog_goc_score	Panda Gene-order conservation score	homologs
amelanoleuca_homolog_wga_coverage	Panda Whole-genome alignment coverage	homologs
amelanoleuca_homolog_dn	dN with Panda	homologs
amelanoleuca_homolog_ds	dS with Panda	homologs
amelanoleuca_homolog_orthology_confidence	Panda orthology confidence [0 low, 1 high]	homologs
sscrofa_homolog_ensembl_gene	Pig gene stable ID	homologs
sscrofa_homolog_associated_gene_name	Pig gene name	homologs
sscrofa_homolog_ensembl_peptide	Pig protein or transcript stable ID	homologs
sscrofa_homolog_chromosome	Pig chromosome/scaffold name	homologs
sscrofa_homolog_chrom_start	Pig chromosome/scaffold start (bp)	homologs
sscrofa_homolog_chrom_end	Pig chromosome/scaffold end (bp)	homologs
sscrofa_homolog_canonical_transcript_protein	Query protein or transcript ID	homologs
sscrofa_homolog_subtype	Last common ancestor with Pig	homologs
sscrofa_homolog_orthology_type	Pig homology type	homologs
sscrofa_homolog_perc_id	%id. target Pig gene identical to query gene	homologs
sscrofa_homolog_perc_id_r1	%id. query gene identical to target Pig gene	homologs
sscrofa_homolog_goc_score	Pig Gene-order conservation score	homologs
sscrofa_homolog_wga_coverage	Pig Whole-genome alignment coverage	homologs
sscrofa_homolog_dn	dN with Pig	homologs
sscrofa_homolog_ds	dS with Pig	homologs
sscrofa_homolog_orthology_confidence	Pig orthology confidence [0 low, 1 high]	homologs
oprinceps_homolog_ensembl_gene	Pika gene stable ID	homologs
oprinceps_homolog_associated_gene_name	Pika gene name	homologs
oprinceps_homolog_ensembl_peptide	Pika protein or transcript stable ID	homologs
oprinceps_homolog_chromosome	Pika chromosome/scaffold name	homologs
oprinceps_homolog_chrom_start	Pika chromosome/scaffold start (bp)	homologs
oprinceps_homolog_chrom_end	Pika chromosome/scaffold end (bp)	homologs
oprinceps_homolog_canonical_transcript_protein	Query protein or transcript ID	homologs
oprinceps_homolog_subtype	Last common ancestor with Pika	homologs
oprinceps_homolog_orthology_type	Pika homology type	homologs
oprinceps_homolog_perc_id	%id. target Pika gene identical to query gene	homologs
oprinceps_homolog_perc_id_r1	%id. query gene identical to target Pika gene	homologs
oprinceps_homolog_goc_score	Pika Gene-order conservation score	homologs
oprinceps_homolog_wga_coverage	Pika Whole-genome alignment coverage	homologs
oprinceps_homolog_dn	dN with Pika	homologs
oprinceps_homolog_ds	dS with Pika	homologs
oprinceps_homolog_orthology_confidence	Pika orthology confidence [0 low, 1 high]	homologs
xmaculatus_homolog_ensembl_gene	Platyfish gene stable ID	homologs
xmaculatus_homolog_associated_gene_name	Platyfish gene name	homologs
xmaculatus_homolog_ensembl_peptide	Platyfish protein or transcript stable ID	homologs
xmaculatus_homolog_chromosome	Platyfish chromosome/scaffold name	homologs
xmaculatus_homolog_chrom_start	Platyfish chromosome/scaffold start (bp)	homologs
xmaculatus_homolog_chrom_end	Platyfish chromosome/scaffold end (bp)	homologs
xmaculatus_homolog_canonical_transcript_protein	Query protein or transcript ID	homologs
xmaculatus_homolog_subtype	Last common ancestor with Platyfish	homologs
xmaculatus_homolog_orthology_type	Platyfish homology type	homologs
xmaculatus_homolog_perc_id	%id. target Platyfish gene identical to query gene	homologs
xmaculatus_homolog_perc_id_r1	%id. query gene identical to target Platyfish gene	homologs
xmaculatus_homolog_goc_score	Platyfish Gene-order conservation score	homologs
xmaculatus_homolog_wga_coverage	Platyfish Whole-genome alignment coverage	homologs
xmaculatus_homolog_dn	dN with Platyfish	homologs
xmaculatus_homolog_ds	dS with Platyfish	homologs
xmaculatus_homolog_orthology_confidence	Platyfish orthology confidence [0 low, 1 high]	homologs
oanatinus_homolog_ensembl_gene	Platypus gene stable ID	homologs
oanatinus_homolog_associated_gene_name	Platypus gene name	homologs
oanatinus_homolog_ensembl_peptide	Platypus protein or transcript stable ID	homologs
oanatinus_homolog_chromosome	Platypus chromosome/scaffold name	homologs
oanatinus_homolog_chrom_start	Platypus chromosome/scaffold start (bp)	homologs
oanatinus_homolog_chrom_end	Platypus chromosome/scaffold end (bp)	homologs
oanatinus_homolog_canonical_transcript_protein	Query protein or transcript ID	homologs
oanatinus_homolog_subtype	Last common ancestor with Platypus	homologs
oanatinus_homolog_orthology_type	Platypus homology type	homologs
oanatinus_homolog_perc_id	%id. target Platypus gene identical to query gene	homologs
oanatinus_homolog_perc_id_r1	%id. query gene identical to target Platypus gene	homologs
oanatinus_homolog_goc_score	Platypus Gene-order conservation score	homologs
oanatinus_homolog_wga_coverage	Platypus Whole-genome alignment coverage	homologs
oanatinus_homolog_dn	dN with Platypus	homologs
oanatinus_homolog_ds	dS with Platypus	homologs
oanatinus_homolog_orthology_confidence	Platypus orthology confidence [0 low, 1 high]	homologs
ocuniculus_homolog_ensembl_gene	Rabbit gene stable ID	homologs
ocuniculus_homolog_associated_gene_name	Rabbit gene name	homologs
ocuniculus_homolog_ensembl_peptide	Rabbit protein or transcript stable ID	homologs
ocuniculus_homolog_chromosome	Rabbit chromosome/scaffold name	homologs
ocuniculus_homolog_chrom_start	Rabbit chromosome/scaffold start (bp)	homologs
ocuniculus_homolog_chrom_end	Rabbit chromosome/scaffold end (bp)	homologs
ocuniculus_homolog_canonical_transcript_protein	Query protein or transcript ID	homologs
ocuniculus_homolog_subtype	Last common ancestor with Rabbit	homologs
ocuniculus_homolog_orthology_type	Rabbit homology type	homologs
ocuniculus_homolog_perc_id	%id. target Rabbit gene identical to query gene	homologs
ocuniculus_homolog_perc_id_r1	%id. query gene identical to target Rabbit gene	homologs
ocuniculus_homolog_goc_score	Rabbit Gene-order conservation score	homologs
ocuniculus_homolog_wga_coverage	Rabbit Whole-genome alignment coverage	homologs
ocuniculus_homolog_dn	dN with Rabbit	homologs
ocuniculus_homolog_ds	dS with Rabbit	homologs
ocuniculus_homolog_orthology_confidence	Rabbit orthology confidence [0 low, 1 high]	homologs
rnorvegicus_homolog_ensembl_gene	Rat gene stable ID	homologs
rnorvegicus_homolog_associated_gene_name	Rat gene name	homologs
rnorvegicus_homolog_ensembl_peptide	Rat protein or transcript stable ID	homologs
rnorvegicus_homolog_chromosome	Rat chromosome/scaffold name	homologs
rnorvegicus_homolog_chrom_start	Rat chromosome/scaffold start (bp)	homologs
rnorvegicus_homolog_chrom_end	Rat chromosome/scaffold end (bp)	homologs
rnorvegicus_homolog_canonical_transcript_protein	Query protein or transcript ID	homologs
rnorvegicus_homolog_subtype	Last common ancestor with Rat	homologs
rnorvegicus_homolog_orthology_type	Rat homology type	homologs
rnorvegicus_homolog_perc_id	%id. target Rat gene identical to query gene	homologs
rnorvegicus_homolog_perc_id_r1	%id. query gene identical to target Rat gene	homologs
rnorvegicus_homolog_goc_score	Rat Gene-order conservation score	homologs
rnorvegicus_homolog_wga_coverage	Rat Whole-genome alignment coverage	homologs
rnorvegicus_homolog_dn	dN with Rat	homologs
rnorvegicus_homolog_ds	dS with Rat	homologs
rnorvegicus_homolog_orthology_confidence	Rat orthology confidence [0 low, 1 high]	homologs
scerevisiae_homolog_ensembl_gene	Saccharomyces cerevisiae gene stable ID	homologs
scerevisiae_homolog_associated_gene_name	Saccharomyces cerevisiae gene name	homologs
scerevisiae_homolog_ensembl_peptide	Saccharomyces cerevisiae protein or transcript stable ID	homologs
scerevisiae_homolog_chromosome	Saccharomyces cerevisiae chromosome/scaffold name	homologs
scerevisiae_homolog_chrom_start	Saccharomyces cerevisiae chromosome/scaffold start (bp)	homologs
scerevisiae_homolog_chrom_end	Saccharomyces cerevisiae chromosome/scaffold end (bp)	homologs
scerevisiae_homolog_canonical_transcript_protein	Query protein or transcript ID	homologs
scerevisiae_homolog_subtype	Last common ancestor with Saccharomyces cerevisiae	homologs
scerevisiae_homolog_orthology_type	Saccharomyces cerevisiae homology type	homologs
scerevisiae_homolog_perc_id	%id. target Saccharomyces cerevisiae gene identical to query gene	homologs
scerevisiae_homolog_perc_id_r1	%id. query gene identical to target Saccharomyces cerevisiae gene	homologs
scerevisiae_homolog_goc_score	Saccharomyces cerevisiae Gene-order conservation score	homologs
scerevisiae_homolog_wga_coverage	Saccharomyces cerevisiae Whole-genome alignment coverage	homologs
scerevisiae_homolog_dn	dN with Saccharomyces cerevisiae	homologs
scerevisiae_homolog_ds	dS with Saccharomyces cerevisiae	homologs
scerevisiae_homolog_orthology_confidence	Saccharomyces cerevisiae orthology confidence [0 low, 1 high]	homologs
oaries_homolog_ensembl_gene	Sheep gene stable ID	homologs
oaries_homolog_associated_gene_name	Sheep gene name	homologs
oaries_homolog_ensembl_peptide	Sheep protein or transcript stable ID	homologs
oaries_homolog_chromosome	Sheep chromosome/scaffold name	homologs
oaries_homolog_chrom_start	Sheep chromosome/scaffold start (bp)	homologs
oaries_homolog_chrom_end	Sheep chromosome/scaffold end (bp)	homologs
oaries_homolog_canonical_transcript_protein	Query protein or transcript ID	homologs
oaries_homolog_subtype	Last common ancestor with Sheep	homologs
oaries_homolog_orthology_type	Sheep homology type	homologs
oaries_homolog_perc_id	%id. target Sheep gene identical to query gene	homologs
oaries_homolog_perc_id_r1	%id. query gene identical to target Sheep gene	homologs
oaries_homolog_goc_score	Sheep Gene-order conservation score	homologs
oaries_homolog_wga_coverage	Sheep Whole-genome alignment coverage	homologs
oaries_homolog_dn	dN with Sheep	homologs
oaries_homolog_ds	dS with Sheep	homologs
oaries_homolog_orthology_confidence	Sheep orthology confidence [0 low, 1 high]	homologs
saraneus_homolog_ensembl_gene	Shrew gene stable ID	homologs
saraneus_homolog_associated_gene_name	Shrew gene name	homologs
saraneus_homolog_ensembl_peptide	Shrew protein or transcript stable ID	homologs
saraneus_homolog_chromosome	Shrew chromosome/scaffold name	homologs
saraneus_homolog_chrom_start	Shrew chromosome/scaffold start (bp)	homologs
saraneus_homolog_chrom_end	Shrew chromosome/scaffold end (bp)	homologs
saraneus_homolog_canonical_transcript_protein	Query protein or transcript ID	homologs
saraneus_homolog_subtype	Last common ancestor with Shrew	homologs
saraneus_homolog_orthology_type	Shrew homology type	homologs
saraneus_homolog_perc_id	%id. target Shrew gene identical to query gene	homologs
saraneus_homolog_perc_id_r1	%id. query gene identical to target Shrew gene	homologs
saraneus_homolog_goc_score	Shrew Gene-order conservation score	homologs
saraneus_homolog_wga_coverage	Shrew Whole-genome alignment coverage	homologs
saraneus_homolog_dn	dN with Shrew	homologs
saraneus_homolog_ds	dS with Shrew	homologs
saraneus_homolog_orthology_confidence	Shrew orthology confidence [0 low, 1 high]	homologs
choffmanni_homolog_ensembl_gene	Sloth gene stable ID	homologs
choffmanni_homolog_associated_gene_name	Sloth gene name	homologs
choffmanni_homolog_ensembl_peptide	Sloth protein or transcript stable ID	homologs
choffmanni_homolog_chromosome	Sloth chromosome/scaffold name	homologs
choffmanni_homolog_chrom_start	Sloth chromosome/scaffold start (bp)	homologs
choffmanni_homolog_chrom_end	Sloth chromosome/scaffold end (bp)	homologs
choffmanni_homolog_canonical_transcript_protein	Query protein or transcript ID	homologs
choffmanni_homolog_subtype	Last common ancestor with Sloth	homologs
choffmanni_homolog_orthology_type	Sloth homology type	homologs
choffmanni_homolog_perc_id	%id. target Sloth gene identical to query gene	homologs
choffmanni_homolog_perc_id_r1	%id. query gene identical to target Sloth gene	homologs
choffmanni_homolog_goc_score	Sloth Gene-order conservation score	homologs
choffmanni_homolog_wga_coverage	Sloth Whole-genome alignment coverage	homologs
choffmanni_homolog_dn	dN with Sloth	homologs
choffmanni_homolog_ds	dS with Sloth	homologs
choffmanni_homolog_orthology_confidence	Sloth orthology confidence [0 low, 1 high]	homologs
loculatus_homolog_ensembl_gene	Spotted gar gene stable ID	homologs
loculatus_homolog_associated_gene_name	Spotted gar gene name	homologs
loculatus_homolog_ensembl_peptide	Spotted gar protein or transcript stable ID	homologs
loculatus_homolog_chromosome	Spotted gar chromosome/scaffold name	homologs
loculatus_homolog_chrom_start	Spotted gar chromosome/scaffold start (bp)	homologs
loculatus_homolog_chrom_end	Spotted gar chromosome/scaffold end (bp)	homologs
loculatus_homolog_canonical_transcript_protein	Query protein or transcript ID	homologs
loculatus_homolog_subtype	Last common ancestor with Spotted gar	homologs
loculatus_homolog_orthology_type	Spotted gar homology type	homologs
loculatus_homolog_perc_id	%id. target Spotted gar gene identical to query gene	homologs
loculatus_homolog_perc_id_r1	%id. query gene identical to target Spotted gar gene	homologs
loculatus_homolog_goc_score	Spotted gar Gene-order conservation score	homologs
loculatus_homolog_wga_coverage	Spotted gar Whole-genome alignment coverage	homologs
loculatus_homolog_dn	dN with Spotted gar	homologs
loculatus_homolog_ds	dS with Spotted gar	homologs
loculatus_homolog_orthology_confidence	Spotted gar orthology confidence [0 low, 1 high]	homologs
itridecemlineatus_homolog_ensembl_gene	Squirrel gene stable ID	homologs
itridecemlineatus_homolog_associated_gene_name	Squirrel gene name	homologs
itridecemlineatus_homolog_ensembl_peptide	Squirrel protein or transcript stable ID	homologs
itridecemlineatus_homolog_chromosome	Squirrel chromosome/scaffold name	homologs
itridecemlineatus_homolog_chrom_start	Squirrel chromosome/scaffold start (bp)	homologs
itridecemlineatus_homolog_chrom_end	Squirrel chromosome/scaffold end (bp)	homologs
itridecemlineatus_homolog_canonical_transcript_protein	Query protein or transcript ID	homologs
itridecemlineatus_homolog_subtype	Last common ancestor with Squirrel	homologs
itridecemlineatus_homolog_orthology_type	Squirrel homology type	homologs
itridecemlineatus_homolog_perc_id	%id. target Squirrel gene identical to query gene	homologs
itridecemlineatus_homolog_perc_id_r1	%id. query gene identical to target Squirrel gene	homologs
itridecemlineatus_homolog_goc_score	Squirrel Gene-order conservation score	homologs
itridecemlineatus_homolog_wga_coverage	Squirrel Whole-genome alignment coverage	homologs
itridecemlineatus_homolog_dn	dN with Squirrel	homologs
itridecemlineatus_homolog_ds	dS with Squirrel	homologs
itridecemlineatus_homolog_orthology_confidence	Squirrel orthology confidence [0 low, 1 high]	homologs
gaculeatus_homolog_ensembl_gene	Stickleback gene stable ID	homologs
gaculeatus_homolog_associated_gene_name	Stickleback gene name	homologs
gaculeatus_homolog_ensembl_peptide	Stickleback protein or transcript stable ID	homologs
gaculeatus_homolog_chromosome	Stickleback chromosome/scaffold name	homologs
gaculeatus_homolog_chrom_start	Stickleback chromosome/scaffold start (bp)	homologs
gaculeatus_homolog_chrom_end	Stickleback chromosome/scaffold end (bp)	homologs
gaculeatus_homolog_canonical_transcript_protein	Query protein or transcript ID	homologs
gaculeatus_homolog_subtype	Last common ancestor with Stickleback	homologs
gaculeatus_homolog_orthology_type	Stickleback homology type	homologs
gaculeatus_homolog_perc_id	%id. target Stickleback gene identical to query gene	homologs
gaculeatus_homolog_perc_id_r1	%id. query gene identical to target Stickleback gene	homologs
gaculeatus_homolog_goc_score	Stickleback Gene-order conservation score	homologs
gaculeatus_homolog_wga_coverage	Stickleback Whole-genome alignment coverage	homologs
gaculeatus_homolog_dn	dN with Stickleback	homologs
gaculeatus_homolog_ds	dS with Stickleback	homologs
gaculeatus_homolog_orthology_confidence	Stickleback orthology confidence [0 low, 1 high]	homologs
tsyrichta_homolog_ensembl_gene	Tarsier gene stable ID	homologs
tsyrichta_homolog_associated_gene_name	Tarsier gene name	homologs
tsyrichta_homolog_ensembl_peptide	Tarsier protein or transcript stable ID	homologs
tsyrichta_homolog_chromosome	Tarsier chromosome/scaffold name	homologs
tsyrichta_homolog_chrom_start	Tarsier chromosome/scaffold start (bp)	homologs
tsyrichta_homolog_chrom_end	Tarsier chromosome/scaffold end (bp)	homologs
tsyrichta_homolog_canonical_transcript_protein	Query protein or transcript ID	homologs
tsyrichta_homolog_subtype	Last common ancestor with Tarsier	homologs
tsyrichta_homolog_orthology_type	Tarsier homology type	homologs
tsyrichta_homolog_perc_id	%id. target Tarsier gene identical to query gene	homologs
tsyrichta_homolog_perc_id_r1	%id. query gene identical to target Tarsier gene	homologs
tsyrichta_homolog_goc_score	Tarsier Gene-order conservation score	homologs
tsyrichta_homolog_wga_coverage	Tarsier Whole-genome alignment coverage	homologs
tsyrichta_homolog_dn	dN with Tarsier	homologs
tsyrichta_homolog_ds	dS with Tarsier	homologs
tsyrichta_homolog_orthology_confidence	Tarsier orthology confidence [0 low, 1 high]	homologs
sharrisii_homolog_ensembl_gene	Tasmanian devil gene stable ID	homologs
sharrisii_homolog_associated_gene_name	Tasmanian devil gene name	homologs
sharrisii_homolog_ensembl_peptide	Tasmanian devil protein or transcript stable ID	homologs
sharrisii_homolog_chromosome	Tasmanian devil chromosome/scaffold name	homologs
sharrisii_homolog_chrom_start	Tasmanian devil chromosome/scaffold start (bp)	homologs
sharrisii_homolog_chrom_end	Tasmanian devil chromosome/scaffold end (bp)	homologs
sharrisii_homolog_canonical_transcript_protein	Query protein or transcript ID	homologs
sharrisii_homolog_subtype	Last common ancestor with Tasmanian devil	homologs
sharrisii_homolog_orthology_type	Tasmanian devil homology type	homologs
sharrisii_homolog_perc_id	%id. target Tasmanian devil gene identical to query gene	homologs
sharrisii_homolog_perc_id_r1	%id. query gene identical to target Tasmanian devil gene	homologs
sharrisii_homolog_goc_score	Tasmanian devil Gene-order conservation score	homologs
sharrisii_homolog_wga_coverage	Tasmanian devil Whole-genome alignment coverage	homologs
sharrisii_homolog_dn	dN with Tasmanian devil	homologs
sharrisii_homolog_ds	dS with Tasmanian devil	homologs
sharrisii_homolog_orthology_confidence	Tasmanian devil orthology confidence [0 low, 1 high]	homologs
tnigroviridis_homolog_ensembl_gene	Tetraodon gene stable ID	homologs
tnigroviridis_homolog_associated_gene_name	Tetraodon gene name	homologs
tnigroviridis_homolog_ensembl_peptide	Tetraodon protein or transcript stable ID	homologs
tnigroviridis_homolog_chromosome	Tetraodon chromosome/scaffold name	homologs
tnigroviridis_homolog_chrom_start	Tetraodon chromosome/scaffold start (bp)	homologs
tnigroviridis_homolog_chrom_end	Tetraodon chromosome/scaffold end (bp)	homologs
tnigroviridis_homolog_canonical_transcript_protein	Query protein or transcript ID	homologs
tnigroviridis_homolog_subtype	Last common ancestor with Tetraodon	homologs
tnigroviridis_homolog_orthology_type	Tetraodon homology type	homologs
tnigroviridis_homolog_perc_id	%id. target Tetraodon gene identical to query gene	homologs
tnigroviridis_homolog_perc_id_r1	%id. query gene identical to target Tetraodon gene	homologs
tnigroviridis_homolog_goc_score	Tetraodon Gene-order conservation score	homologs
tnigroviridis_homolog_wga_coverage	Tetraodon Whole-genome alignment coverage	homologs
tnigroviridis_homolog_dn	dN with Tetraodon	homologs
tnigroviridis_homolog_ds	dS with Tetraodon	homologs
tnigroviridis_homolog_orthology_confidence	Tetraodon orthology confidence [0 low, 1 high]	homologs
oniloticus_homolog_ensembl_gene	Tilapia gene stable ID	homologs
oniloticus_homolog_associated_gene_name	Tilapia gene name	homologs
oniloticus_homolog_ensembl_peptide	Tilapia protein or transcript stable ID	homologs
oniloticus_homolog_chromosome	Tilapia chromosome/scaffold name	homologs
oniloticus_homolog_chrom_start	Tilapia chromosome/scaffold start (bp)	homologs
oniloticus_homolog_chrom_end	Tilapia chromosome/scaffold end (bp)	homologs
oniloticus_homolog_canonical_transcript_protein	Query protein or transcript ID	homologs
oniloticus_homolog_subtype	Last common ancestor with Tilapia	homologs
oniloticus_homolog_orthology_type	Tilapia homology type	homologs
oniloticus_homolog_perc_id	%id. target Tilapia gene identical to query gene	homologs
oniloticus_homolog_perc_id_r1	%id. query gene identical to target Tilapia gene	homologs
oniloticus_homolog_goc_score	Tilapia Gene-order conservation score	homologs
oniloticus_homolog_wga_coverage	Tilapia Whole-genome alignment coverage	homologs
oniloticus_homolog_dn	dN with Tilapia	homologs
oniloticus_homolog_ds	dS with Tilapia	homologs
oniloticus_homolog_orthology_confidence	Tilapia orthology confidence [0 low, 1 high]	homologs
tbelangeri_homolog_ensembl_gene	Tree Shrew gene stable ID	homologs
tbelangeri_homolog_associated_gene_name	Tree Shrew gene name	homologs
tbelangeri_homolog_ensembl_peptide	Tree Shrew protein or transcript stable ID	homologs
tbelangeri_homolog_chromosome	Tree Shrew chromosome/scaffold name	homologs
tbelangeri_homolog_chrom_start	Tree Shrew chromosome/scaffold start (bp)	homologs
tbelangeri_homolog_chrom_end	Tree Shrew chromosome/scaffold end (bp)	homologs
tbelangeri_homolog_canonical_transcript_protein	Query protein or transcript ID	homologs
tbelangeri_homolog_subtype	Last common ancestor with Tree Shrew	homologs
tbelangeri_homolog_orthology_type	Tree Shrew homology type	homologs
tbelangeri_homolog_perc_id	%id. target Tree Shrew gene identical to query gene	homologs
tbelangeri_homolog_perc_id_r1	%id. query gene identical to target Tree Shrew gene	homologs
tbelangeri_homolog_goc_score	Tree Shrew Gene-order conservation score	homologs
tbelangeri_homolog_wga_coverage	Tree Shrew Whole-genome alignment coverage	homologs
tbelangeri_homolog_dn	dN with Tree Shrew	homologs
tbelangeri_homolog_ds	dS with Tree Shrew	homologs
tbelangeri_homolog_orthology_confidence	Tree Shrew orthology confidence [0 low, 1 high]	homologs
mgallopavo_homolog_ensembl_gene	Turkey gene stable ID	homologs
mgallopavo_homolog_associated_gene_name	Turkey gene name	homologs
mgallopavo_homolog_ensembl_peptide	Turkey protein or transcript stable ID	homologs
mgallopavo_homolog_chromosome	Turkey chromosome/scaffold name	homologs
mgallopavo_homolog_chrom_start	Turkey chromosome/scaffold start (bp)	homologs
mgallopavo_homolog_chrom_end	Turkey chromosome/scaffold end (bp)	homologs
mgallopavo_homolog_canonical_transcript_protein	Query protein or transcript ID	homologs
mgallopavo_homolog_subtype	Last common ancestor with Turkey	homologs
mgallopavo_homolog_orthology_type	Turkey homology type	homologs
mgallopavo_homolog_perc_id	%id. target Turkey gene identical to query gene	homologs
mgallopavo_homolog_perc_id_r1	%id. query gene identical to target Turkey gene	homologs
mgallopavo_homolog_goc_score	Turkey Gene-order conservation score	homologs
mgallopavo_homolog_wga_coverage	Turkey Whole-genome alignment coverage	homologs
mgallopavo_homolog_dn	dN with Turkey	homologs
mgallopavo_homolog_ds	dS with Turkey	homologs
mgallopavo_homolog_orthology_confidence	Turkey orthology confidence [0 low, 1 high]	homologs
meugenii_homolog_ensembl_gene	Wallaby gene stable ID	homologs
meugenii_homolog_associated_gene_name	Wallaby gene name	homologs
meugenii_homolog_ensembl_peptide	Wallaby protein or transcript stable ID	homologs
meugenii_homolog_chromosome	Wallaby chromosome/scaffold name	homologs
meugenii_homolog_chrom_start	Wallaby chromosome/scaffold start (bp)	homologs
meugenii_homolog_chrom_end	Wallaby chromosome/scaffold end (bp)	homologs
meugenii_homolog_canonical_transcript_protein	Query protein or transcript ID	homologs
meugenii_homolog_subtype	Last common ancestor with Wallaby	homologs
meugenii_homolog_orthology_type	Wallaby homology type	homologs
meugenii_homolog_perc_id	%id. target Wallaby gene identical to query gene	homologs
meugenii_homolog_perc_id_r1	%id. query gene identical to target Wallaby gene	homologs
meugenii_homolog_goc_score	Wallaby Gene-order conservation score	homologs
meugenii_homolog_wga_coverage	Wallaby Whole-genome alignment coverage	homologs
meugenii_homolog_dn	dN with Wallaby	homologs
meugenii_homolog_ds	dS with Wallaby	homologs
meugenii_homolog_orthology_confidence	Wallaby orthology confidence [0 low, 1 high]	homologs
xtropicalis_homolog_ensembl_gene	Xenopus gene stable ID	homologs
xtropicalis_homolog_associated_gene_name	Xenopus gene name	homologs
xtropicalis_homolog_ensembl_peptide	Xenopus protein or transcript stable ID	homologs
xtropicalis_homolog_chromosome	Xenopus chromosome/scaffold name	homologs
xtropicalis_homolog_chrom_start	Xenopus chromosome/scaffold start (bp)	homologs
xtropicalis_homolog_chrom_end	Xenopus chromosome/scaffold end (bp)	homologs
xtropicalis_homolog_canonical_transcript_protein	Query protein or transcript ID	homologs
xtropicalis_homolog_subtype	Last common ancestor with Xenopus	homologs
xtropicalis_homolog_orthology_type	Xenopus homology type	homologs
xtropicalis_homolog_perc_id	%id. target Xenopus gene identical to query gene	homologs
xtropicalis_homolog_perc_id_r1	%id. query gene identical to target Xenopus gene	homologs
xtropicalis_homolog_goc_score	Xenopus Gene-order conservation score	homologs
xtropicalis_homolog_wga_coverage	Xenopus Whole-genome alignment coverage	homologs
xtropicalis_homolog_dn	dN with Xenopus	homologs
xtropicalis_homolog_ds	dS with Xenopus	homologs
xtropicalis_homolog_orthology_confidence	Xenopus orthology confidence [0 low, 1 high]	homologs
tguttata_homolog_ensembl_gene	Zebra Finch gene stable ID	homologs
tguttata_homolog_associated_gene_name	Zebra Finch gene name	homologs
tguttata_homolog_ensembl_peptide	Zebra Finch protein or transcript stable ID	homologs
tguttata_homolog_chromosome	Zebra Finch chromosome/scaffold name	homologs
tguttata_homolog_chrom_start	Zebra Finch chromosome/scaffold start (bp)	homologs
tguttata_homolog_chrom_end	Zebra Finch chromosome/scaffold end (bp)	homologs
tguttata_homolog_canonical_transcript_protein	Query protein or transcript ID	homologs
tguttata_homolog_subtype	Last common ancestor with Zebra Finch	homologs
tguttata_homolog_orthology_type	Zebra Finch homology type	homologs
tguttata_homolog_perc_id	%id. target Zebra Finch gene identical to query gene	homologs
tguttata_homolog_perc_id_r1	%id. query gene identical to target Zebra Finch gene	homologs
tguttata_homolog_goc_score	Zebra Finch Gene-order conservation score	homologs
tguttata_homolog_wga_coverage	Zebra Finch Whole-genome alignment coverage	homologs
tguttata_homolog_dn	dN with Zebra Finch	homologs
tguttata_homolog_ds	dS with Zebra Finch	homologs
tguttata_homolog_orthology_confidence	Zebra Finch orthology confidence [0 low, 1 high]	homologs
drerio_homolog_ensembl_gene	Zebrafish gene stable ID	homologs
drerio_homolog_associated_gene_name	Zebrafish gene name	homologs
drerio_homolog_ensembl_peptide	Zebrafish protein or transcript stable ID	homologs
drerio_homolog_chromosome	Zebrafish chromosome/scaffold name	homologs
drerio_homolog_chrom_start	Zebrafish chromosome/scaffold start (bp)	homologs
drerio_homolog_chrom_end	Zebrafish chromosome/scaffold end (bp)	homologs
drerio_homolog_canonical_transcript_protein	Query protein or transcript ID	homologs
drerio_homolog_subtype	Last common ancestor with Zebrafish	homologs
drerio_homolog_orthology_type	Zebrafish homology type	homologs
drerio_homolog_perc_id	%id. target Zebrafish gene identical to query gene	homologs
drerio_homolog_perc_id_r1	%id. query gene identical to target Zebrafish gene	homologs
drerio_homolog_goc_score	Zebrafish Gene-order conservation score	homologs
drerio_homolog_wga_coverage	Zebrafish Whole-genome alignment coverage	homologs
drerio_homolog_dn	dN with Zebrafish	homologs
drerio_homolog_ds	dS with Zebrafish	homologs
drerio_homolog_orthology_confidence	Zebrafish orthology confidence [0 low, 1 high]	homologs
hsapiens_paralog_ensembl_gene	Human paralogue gene stable ID	homologs
hsapiens_paralog_associated_gene_name	Human paralogue associated gene name	homologs
hsapiens_paralog_ensembl_peptide	Human paralogue protein or transcript ID	homologs
hsapiens_paralog_chromosome	Human paralogue chromosome/scaffold name	homologs
hsapiens_paralog_chrom_start	Human paralogue chromosome/scaffold start (bp)	homologs
hsapiens_paralog_chrom_end	Human paralogue chromosome/scaffold end (bp)	homologs
hsapiens_paralog_canonical_transcript_protein	Paralogue query protein or transcript ID	homologs
hsapiens_paralog_subtype	Paralogue last common ancestor with Human	homologs
hsapiens_paralog_orthology_type	Human paralogue homology type	homologs
hsapiens_paralog_perc_id	Paralogue %id. target Human gene identical to query gene	homologs
hsapiens_paralog_perc_id_r1	Paralogue %id. query gene identical to target Human gene	homologs
hsapiens_paralog_dn	Paralogue dN with Human	homologs
hsapiens_paralog_ds	Paralogue dS with Human	homologs
hsapiens_paralog_paralogy_confidence	Human paralogy confidence [0 low, 1 high]	homologs
ensembl_gene_id	Gene stable ID	snp
ensembl_transcript_id	Transcript stable ID	snp
ensembl_peptide_id	Protein stable ID	snp
chromosome_name	Chromosome/scaffold name	snp
start_position	Gene start (bp)	snp
end_position	Gene end (bp)	snp
strand	Strand	snp
band	Karyotype band	snp
external_gene_name	Gene name	snp
external_gene_source	Source of gene name	snp
transcript_count	Transcript count	snp
percentage_gene_gc_content	Gene % GC content	snp
description	Gene description	snp
variation_name	Variant name	snp
germ_line_variation_source	Variant source	snp
source_description	Variant source description	snp
allele	Variant alleles	snp
validated	Variant supporting evidence	snp
mapweight	Mapweight	snp
minor_allele	Minor allele	snp
minor_allele_freq	Minor allele frequency	snp
minor_allele_count	Minor allele count	snp
clinical_significance	Clinical significance	snp
transcript_location	Transcript location (bp)	snp
snp_chromosome_strand	Variant chromosome Strand	snp
peptide_location	Protein location (aa)	snp
chromosome_start	chromosome/scaffold position start (bp)	snp
chromosome_end	Chromosome/scaffold position end (bp)	snp
polyphen_prediction_2076	PolyPhen prediction	snp
polyphen_score_2076	PolyPhen score	snp
sift_prediction_2076	SIFT prediction	snp
sift_score_2076	SIFT score	snp
distance_to_transcript_2076	Distance to transcript	snp
cds_start_2076	CDS start	snp
cds_end_2076	CDS end	snp
peptide_shift	Protein allele	snp
synonymous_status	Variant consequence	snp
allele_string_2076	Consequence specific allele	snp
ensembl_gene_id	Gene stable ID	snp_somatic
ensembl_transcript_id	Transcript stable ID	snp_somatic
ensembl_peptide_id	Protein stable ID	snp_somatic
chromosome_name	Chromosome/scaffold name	snp_somatic
start_position	Gene start (bp)	snp_somatic
end_position	Gene end (bp)	snp_somatic
strand	Strand	snp_somatic
band	Karyotype band	snp_somatic
external_gene_name	Gene name	snp_somatic
external_gene_source	Source of gene name	snp_somatic
transcript_count	Transcript count	snp_somatic
percentage_gene_gc_content	Gene % GC content	snp_somatic
description	Gene description	snp_somatic
somatic_variation_name	Variant name	snp_somatic
somatic_source_name	Variant source	snp_somatic
somatic_source_description	Variant source description	snp_somatic
somatic_allele	Variant alleles	snp_somatic
somatic_validated	Variant supporting evidence	snp_somatic
somatic_mapweight	Mapweight	snp_somatic
somatic_minor_allele	Minor allele	snp_somatic
somatic_minor_allele_freq	Minor allele frequency	snp_somatic
somatic_minor_allele_count	Minor allele count	snp_somatic
somatic_clinical_significance	Clinical significance	snp_somatic
somatic_transcript_location	Transcript location (bp)	snp_somatic
somatic_snp_chromosome_strand	Variant chromosome/scaffold strand	snp_somatic
somatic_peptide_location	Protein location (aa)	snp_somatic
somatic_chromosome_start	Chromosome/scaffold position start (bp)	snp_somatic
somatic_chromosome_end	Chromosome/scaffold position end (bp)	snp_somatic
mart_transcript_variation_som__dm_polyphen_prediction_2076	PolyPhen prediction	snp_somatic
mart_transcript_variation_som__dm_polyphen_score_2076	PolyPhen score	snp_somatic
mart_transcript_variation_som__dm_sift_prediction_2076	SIFT prediction	snp_somatic
mart_transcript_variation_som__dm_sift_score_2076	SIFT score	snp_somatic
mart_transcript_variation_som__dm_distance_to_transcript_2076	Distance to transcript	snp_somatic
somatic_cds_start_2076	CDS start	snp_somatic
somatic_cds_end_2076	CDS end	snp_somatic
somatic_peptide_shift	Protein allele	snp_somatic
somatic_synonymous_status	Variant consequence	snp_somatic
mart_transcript_variation_som__dm_allele_string_2076	Consequence specific allele	snp_somatic
transcript_exon_intron	Unspliced (Transcript)	sequences
gene_exon_intron	Unspliced (Gene)	sequences
transcript_flank	Flank (Transcript)	sequences
gene_flank	Flank (Gene)	sequences
coding_transcript_flank	Flank-coding region (Transcript)	sequences
coding_gene_flank	Flank-coding region (Gene)	sequences
5utr	5' UTR	sequences
3utr	3' UTR	sequences
gene_exon	Exon sequences	sequences
cdna	cDNA sequences	sequences
coding	Coding sequence	sequences
peptide	Peptide	sequences
upstream_flank	upstream_flank	sequences
downstream_flank	downstream_flank	sequences
ensembl_gene_id	Gene stable ID	sequences
description	Gene description	sequences
external_gene_name	Gene name	sequences
external_gene_source	Source of gene name	sequences
chromosome_name	Chromosome/scaffold name	sequences
start_position	Gene start (bp)	sequences
end_position	Gene end (bp)	sequences
gene_biotype	Gene type	sequences
family	Ensembl Protein Family ID(s)	sequences
uniparc	UniParc ID	sequences
uniprotswissprot	UniProtKB/Swiss-Prot ID	sequences
uniprotsptrembl	UniProtKB/TrEMBL ID	sequences
cdna_coding_start	CDS start (within cDNA)	sequences
cdna_coding_end	CDS end (within cDNA)	sequences
5_utr_start	5' UTR start	sequences
5_utr_end	5' UTR end	sequences
3_utr_start	3' UTR start	sequences
3_utr_end	3' UTR end	sequences
ensembl_transcript_id	Transcript stable ID	sequences
ensembl_peptide_id	Protein stable ID	sequences
transcript_biotype	Transcript type	sequences
strand	Strand	sequences
transcript_start	Transcript start (bp)	sequences
transcript_end	Transcript end (bp)	sequences
transcription_start_site	Transcription start site (TSS)	sequences
transcript_length	Transcript length (including UTRs and CDS)	sequences
cds_length	CDS Length	sequences
cds_start	CDS start	sequences
cds_end	CDS end	sequences
ensembl_exon_id	Exon stable ID	sequences
exon_chrom_start	Exon region start (bp)	sequences
exon_chrom_end	Exon region end (bp)	sequences
strand	Strand	sequences
rank	Exon rank in transcript	sequences
phase	Start phase	sequences
end_phase	End phase	sequences
cdna_coding_start	cDNA coding start	sequences
cdna_coding_end	cDNA coding end	sequences
genomic_coding_start	Genomic coding start	sequences
genomic_coding_end	Genomic coding end	sequences
is_constitutive	Constitutive exon	sequences
